ContigSetID,cbID,contigSet,methodHTML,methodFails,transcriptBaseCoverage,transcriptBaseCoveragePercent,transcriptAdditionalBases,transcriptsPartial,contigBaseCoverage,contigBaseCoveragePercent,contigAssembledBases,contigAdditionalBases,contigsAssembled,contigsTP,contigsFP,contigsFN,contigSensitivity,contigSpecificity,contigFDR,contigF1
StringTie reference,107,StringTie (genome-guided),,,57740105,100,9100952,21342,66841057,100,66841057,0,28638,28638,0,0,1,1,0,1
evi ok,201,Trinity (k=25),evigene ok set,,25360166,43.92,13786296,11865,26491283,39.63,39146462,12655179,28719,13165,15554,15473,0.4597,0.4584,0.5416,0.4591
evi full,201,Trinity (k=25),evigene ok + alt/cull set,,29374846,50.87,30938711,13953,31869264,47.68,60313557,28444293,37083,15428,21655,13210,0.5387,0.416,0.584,0.4695
evi4F --> TF1,202,Trinity (k=25),evigene full set &#8594; Transfuse (filter),,29299942,50.74,28841758,13849,31732156,47.47,58141700,26409544,33172,15172,18000,13466,0.5298,0.4574,0.5426,0.4909
evi4F --> TF2,202,Trinity (k=25),evigene full set &#8594; Transfuse (filter &#8594; vsearch),,29036371,50.29,27937815,13787,31337254,46.88,56974186,25636932,32798,15083,17715,13555,0.5267,0.4599,0.5401,0.491
evi4F --> TF3,202,Trinity (k=25),evigene full set &#8594; Transfuse (filter &#8594; vsearch &#8594; Transrate),,29026327,50.27,27742488,13774,31325572,46.87,56768815,25443243,32690,15066,17624,13572,0.5261,0.4609,0.5391,0.4913
evi4 --> TF --> Det,203,Trinity (k=25),evigene full set &#8594; Transfuse (filter &#8594; vsearch &#8594; Transrate) &#8594; Detonate,,28940851,50.12,25836622,13617,31181278,46.65,54777473,23596195,29665,14781,14884,13857,0.5161,0.4983,0.5017,0.507
transfuse 1 (filter),204,Trinity (k=25),Transfuse (filter),,30814288,53.37,42797908,15073,34369807,51.42,73612196,39242389,52940,17328,35612,11310,0.6051,0.3273,0.6727,0.4248
transfuse 2 (vsearch),204,Trinity (k=25),Transfuse (filter &#8594; vsearch),,30386734,52.63,41163900,14950,33723160,50.45,71550634,37827474,52211,17173,35038,11465,0.5997,0.3289,0.6711,0.4248
transfuse 3 (transrate),204,Trinity (k=25),Transfuse (filter &#8594; vsearch &#8594; Transrate),,30369194,52.6,40625133,14937,33677791,50.38,70994327,37316536,51914,17149,34765,11489,0.5988,0.3303,0.6697,0.4258
TF3 --> Det,205,Trinity (k=25),Transfuse (filter &#8594; vsearch &#8594; Transrate) &#8594; Detonate,,30255146,52.4,36476315,14662,33423623,50,66731461,33307838,42245,16505,25740,12133,0.5763,0.3907,0.6093,0.4657
Detonate,206,Trinity (k=25),Detonate,,30809255,53.36,40779129,14880,34330857,51.36,71588384,37257527,44648,16825,27823,11813,0.5875,0.3768,0.6232,0.4592
evi ok,301,TransLiG (k=25),evigene ok set,,23767814,41.16,14700281,10985,24533750,36.7,38468095,13934345,18073,11681,6392,16957,0.4079,0.6463,0.3537,0.5001
evi full,301,TransLiG (k=25),evigene ok + alt/cull set,,26831305,46.47,25207133,12530,28302432,42.34,52038438,23736006,22548,13323,9225,15315,0.4652,0.5909,0.4091,0.5206
evi4F --> TF1,302,TransLiG (k=25),evigene full set &#8594; Transfuse (filter),,26817196,46.44,24660276,12512,28266815,42.29,51477472,23210657,22234,13290,8944,15348,0.4641,0.5977,0.4023,0.5225
evi4F --> TF2,302,TransLiG (k=25),evigene full set &#8594; Transfuse (filter &#8594; vsearch),,26824646,46.46,24138454,12547,28324975,42.38,50963100,22638125,22033,13352,8681,15286,0.4662,0.606,0.394,0.527
evi4F --> TF3,302,TransLiG (k=25),evigene full set &#8594; Transfuse (filter &#8594; vsearch &#8594; Transrate),,26822231,46.45,24062271,12544,28321230,42.37,50884502,22563272,21985,13342,8643,15296,0.4659,0.6069,0.3931,0.5271
evi4 --> TF --> Det,303,TransLiG (k=25),evigene full set &#8594; Transfuse (filter &#8594; vsearch &#8594; Transrate) &#8594; Detonate,,26762112,46.35,22842352,12452,28232338,42.24,49604464,21372126,21242,13208,8034,15430,0.4612,0.6218,0.3782,0.5296
transfuse 1 (filter),304,TransLiG (k=25),Transfuse (filter),,28030069,48.55,34256053,13419,30212796,45.2,62286122,32073326,28868,14593,14275,14045,0.5096,0.5055,0.4945,0.5075
transfuse 2 (vsearch),304,TransLiG (k=25),Transfuse (filter &#8594; vsearch),,27963801,48.43,33152611,13395,30093100,45.02,61116412,31023312,28330,14569,13761,14069,0.5087,0.5143,0.4857,0.5115
transfuse 3 (transrate),304,TransLiG (k=25),Transfuse (filter &#8594; vsearch &#8594; Transrate),,27957575,48.42,32827474,13388,30074877,44.99,60785049,30710172,28215,14555,13660,14083,0.5082,0.5159,0.4841,0.512
TF3 --> Det,305,TransLiG (k=25),Transfuse (filter &#8594; vsearch &#8594; Transrate) &#8594; Detonate,,27865228,48.26,30259471,13250,29931476,44.78,58124699,28193223,26641,14346,12295,14292,0.5009,0.5385,0.4615,0.519
Detonate,306,TransLiG (k=25),Detonate,,27956003,48.42,31812437,13291,30102505,45.04,59768440,29665935,27476,14424,13052,14214,0.5037,0.525,0.475,0.5141
4 merger; IDBA k=1/3RL; rnaSPAdes def; Trinity k-25; TransLiG k=25,401,4 assemblies merged,with trimmed reads: IDBA k=31; rnaSPAdes k=49; Trinity k=25; TransLiG k=25,,35539609,61.55,247608570,17421,41060732,61.43,283148179,242087447,251145,21043,230102,7595,0.7348,0.0838,0.9162,0.1504
evi ok,402,4 assemblies merged,evigene ok set,,26418906,45.75,25746148,12214,27792261,41.58,52165054,24372793,39036,13894,25142,14744,0.4852,0.3559,0.6441,0.4106
evi full,402,4 assemblies merged,evigene ok + alt/cull set,,32506859,56.3,71792093,15339,35907750,53.72,104298952,68391202,63004,17523,45481,11115,0.6119,0.2781,0.7219,0.3824
evi4F --> TF1,403,4 assemblies merged,evigene full set &#8594; Transfuse (filter),,31722184,54.94,53379430,14967,34650249,51.84,85101614,50451365,46861,16828,30033,11810,0.5876,0.3591,0.6409,0.4458
evi4F --> TF2,403,4 assemblies merged,evigene full set &#8594; Transfuse (filter &#8594; vsearch),,31472678,54.51,51338939,14802,34420321,51.5,82811617,48391296,45531,16682,28849,11956,0.5825,0.3664,0.6336,0.4498
evi4F --> TF3,403,4 assemblies merged,evigene full set &#8594; Transfuse (filter &#8594; vsearch &#8594; Transrate),,31381956,54.35,49711956,14752,34244751,51.23,81093912,46849161,44617,16597,28020,12041,0.5795,0.372,0.628,0.4531
evi4 --> TF --> Det,404,4 assemblies merged,evigene full set &#8594; Transfuse (filter &#8594; vsearch &#8594; Transrate) &#8594; Detonate,,31161508,53.97,43340914,14476,33899211,50.72,74502422,40603211,38035,16155,21880,12483,0.5641,0.4247,0.5753,0.4846
transfuse 1 (filter),405,4 assemblies merged,Transfuse (filter),,33756564,58.46,96737055,16107,38003007,56.86,130493619,92490612,78399,18741,59658,9897,0.6544,0.239,0.761,0.3502
transfuse 2 (vsearch),405,4 assemblies merged,Transfuse (filter &#8594; vsearch),,33406746,57.86,75778639,15910,37462038,56.05,109185385,71723347,65346,18487,46859,10151,0.6455,0.2829,0.7171,0.3934
transfuse 3 (transrate),405,4 assemblies merged,Transfuse (filter &#8594; vsearch &#8594; Transrate),,33193336,57.49,69777157,15785,37047655,55.43,102970493,65922838,61744,18270,43474,10368,0.638,0.2959,0.7041,0.4043
TF3 --> Det,406,4 assemblies merged,Transfuse (filter &#8594; vsearch &#8594; Transrate) &#8594; Detonate,,32979173,57.12,59470446,15450,36663877,54.85,92449619,55785742,49703,17658,32045,10980,0.6166,0.3553,0.6447,0.4508
ORP 1 (orthomerged),408,4 assemblies merged,ORP (orthomerged),,30340271,52.55,61111202,15149,33426479,50.01,91451473,58024994,104598,18129,86469,10509,0.633,0.1733,0.8267,0.2721
ORP 2 (cd-hit),408,4 assemblies merged,ORP (orthomerged &#8594; cd-hit c=1; original method used c=0.98),,30307087,52.49,56750772,15067,33349159,49.89,87057859,53708700,94223,17957,76266,10681,0.627,0.1906,0.8094,0.2923
ORP 3 (High exp),408,4 assemblies merged,ORP (orthomerged &#8594; cd-hit &#8594; high expression TPM&#8805;0.05; original method used TPM&#8805;1),,29967223,51.9,45616162,14750,32798344,49.07,75583385,42785041,69122,17238,51884,11400,0.6019,0.2494,0.7506,0.3527
ORP 4 (with blast),408,4 assemblies merged,ORP (orthomerged &#8594; cd-hit &#8594; high expression &#8594;  blast recovery of low exp.),,30276349,52.44,51813568,14968,33237951,49.73,82089917,48851966,73688,17593,56095,11045,0.6143,0.2387,0.7613,0.3439
15 merger: IDBA 1/3  1/2; rnaSPAdes def; Soap 1/3 1/2; TransLiG k=25 31 + norm; Trinity k=25,501,15 assemblies merged,with trimmed reads: IDBA k=31 41; rnaSPAdes k=49; Soap 25 41; TransLiG k=25 31 <br />with BBmap normalized reads: IDBA k=31 41; rnaSPAdes k=49; Soap 25 41; TransLiG k=25 31 <br />with assembly <em>in-silico normalization</em>: Trinity k=25,,36688647,63.54,795779219,18224,43213296,64.65,832467866,789254570,760250,22406,737844,6232,0.7824,0.0295,0.9705,0.0568
evi ok,502,15 assemblies merged,evigene ok set,,25831327,44.74,31858118,12361,27203200,40.7,57689445,30486245,49907,14186,35721,14452,0.4954,0.2842,0.7158,0.3612
evi full,502,15 assemblies merged,evigene ok + alt/cull set,,33240237,57.57,124211314,16196,37079347,55.47,157451551,120372204,99116,18681,80435,9957,0.6523,0.1885,0.8115,0.2925
evi4F --> TF1,503,15 assemblies merged,evigene full set &#8594; Transfuse (filter),,31740135,54.97,70879099,15458,34849986,52.14,102619234,67769248,58319,17533,40786,11105,0.6122,0.3006,0.6994,0.4033
evi4F --> TF2,503,15 assemblies merged,evigene full set &#8594; Transfuse (filter &#8594; vsearch),,31652675,54.82,68080819,15372,34675557,51.88,99733494,65057937,56270,17422,38848,11216,0.6084,0.3096,0.6904,0.4104
evi4F --> TF3,503,15 assemblies merged,evigene full set &#8594; Transfuse (filter &#8594; vsearch &#8594; Transrate),,31503485,54.56,64266007,15297,34441799,51.53,95769492,61327693,54245,17304,36941,11334,0.6042,0.319,0.681,0.4176
evi4 --> TF --> Det,504,15 assemblies merged,evigene full set &#8594; Transfuse (filter &#8594; vsearch &#8594; Transrate) &#8594; Detonate,,31267059,54.15,54804588,14982,34117459,51.04,86071647,51954188,45142,16827,28315,11811,0.5876,0.3728,0.6272,0.4561
transfuse 1 (filter),505,15 assemblies merged,Transfuse (filter),,33430098,57.9,104157782,16273,37471691,56.06,137587880,100116189,83704,18907,64797,9731,0.6602,0.2259,0.7741,0.3366
transfuse 2 (vsearch),505,15 assemblies merged,Transfuse (filter &#8594; vsearch),,33117864,57.36,75184481,15998,36996239,55.35,108302345,71306106,66186,18580,47606,10058,0.6488,0.2807,0.7193,0.3919
transfuse 3 (transrate),505,15 assemblies merged,Transfuse (filter &#8594; vsearch &#8594; Transrate),,32829199,56.86,67395664,15795,36564747,54.7,100224863,63660116,61279,18317,42962,10321,0.6396,0.2989,0.7011,0.4074
TF3 --> Det,506,15 assemblies merged,Transfuse (filter &#8594; vsearch &#8594; Transrate) &#8594; Detonate,,32637804,56.53,59080455,15485,36233955,54.21,91718259,55484304,50390,17751,32639,10887,0.6198,0.3523,0.6477,0.4492
ORP 1 (orthomerged),508,15 assemblies merged,ORP (orthomerged),,27120479,46.97,62127873,14677,29249908,43.76,89248352,59998444,139069,17513,121556,11125,0.6115,0.1259,0.8741,0.2089
ORP 2 (cd-hit),508,15 assemblies merged,ORP (orthomerged &#8594; cd-hit c=1; original method used c=0.98),,27042682,46.84,48940065,14497,29139663,43.6,75982747,46843084,102336,17222,85114,11416,0.6014,0.1683,0.8317,0.263
ORP 3 (High exp),508,15 assemblies merged,ORP (orthomerged &#8594; cd-hit &#8594; high expression TPM&#8805;0.05; original method used TPM&#8805;1),,26955330,46.68,44488912,14378,29018706,43.41,71444242,42425536,90216,17061,73155,11577,0.5957,0.1891,0.8109,0.2871
ORP 4 (with blast),508,15 assemblies merged,ORP (orthomerged &#8594; cd-hit &#8594; high expression &#8594;  blast recovery of low exp.),,27037503,46.83,46794675,14453,29124919,43.57,73832178,44707259,92783,17143,75640,11495,0.5986,0.1848,0.8152,0.2824
All + norm,601,all (58) assemblies merged,with trimmed reads: IDBA k=21-71 step 10; rnaSPAdes k=29 33 49 55; Soap k=21-31 step 2 &amp; k=41-71 step 10; TransLiG k=21-31 step 2 <br />with BBmap normalized reads: IDBA k=21-71 step 10; rnaSPAdes k=29 33 49 55; Soap k=21-31 step 2 &amp; k=41-71 step 10; TransLiG k=21-31 step 2 <br />with assembly <em>in-silico normalization</em>: Trinity k=21-31 step 2,,37703864,65.3,2970305081,18873,45098654,67.47,3008008945,2962910291,2917784,23675,2894109,4963,0.8267,0.0081,0.9919,0.0161
evigene full,602,all (58) assemblies merged,evigene ok + alt/cull set,,33974685,58.84,241182484,17209,38329416,57.34,275157169,236827753,169633,20151,149482,8487,0.7036,0.1188,0.8812,0.2033
evi4F --> TF1,603,all (58) assemblies merged,evigene full set &#8594; Transfuse (filter),,31724183,54.94,90519053,16066,34865707,52.16,122243236,87377529,70480,18273,52207,10365,0.6381,0.2593,0.7407,0.3687
evi4F --> TF2,603,all (58) assemblies merged,evigene full set &#8594; Transfuse (filter &#8594; vsearch),,31638557,54.79,87355295,15953,34793479,52.05,118993852,84200373,67965,18201,49764,10437,0.6356,0.2678,0.7322,0.3768
evi4F --> TF3,603,all (58) assemblies merged,evigene full set &#8594; Transfuse (filter &#8594; vsearch &#8594; Transrate),,31333201,54.27,79102846,15794,34369729,51.42,110436047,76066318,63714,17972,45742,10666,0.6276,0.2821,0.7179,0.3892
evi4 --> TF --> Det,604,all (58) assemblies merged,evigene full set &#8594; Transfuse (filter &#8594; vsearch &#8594; Transrate) &#8594; Detonate,,31070243,53.81,65623653,15436,33930108,50.76,96693896,62763788,51539,17403,34136,11235,0.6077,0.3377,0.6623,0.4341
con2-eviFull Best evi set,606,all (58) assemblies merged,intersection of consensus 2 and evigene full sets,,20358908,35.26,49894153,10950,22128518,33.11,70253061,48124543,32384,12099,20285,16539,0.4225,0.3736,0.6264,0.3965
con2/evi4 -- Transfuse 1,607,all (58) assemblies merged,con2 U evigene full &#8594; Transfuse (filter),,19864064,34.4,37666781,10617,21334700,31.92,57530845,36196145,25708,11637,14071,17001,0.4063,0.4527,0.5473,0.4283
con2/evi4 -- Transfuse 2,607,all (58) assemblies merged,con2 U evigene full &#8594; Transfuse (filter &#8594; vsearch),,19842529,34.37,37541578,10601,21346199,31.94,57384107,36037908,25675,11612,14063,17026,0.4055,0.4523,0.5477,0.4276
con2/evi4 -- Transfuse 3,607,all (58) assemblies merged,con2 U evigene full &#8594; Transfuse (filter &#8594; vsearch &#8594; Transrate),,19781714,34.26,36625292,10563,21280080,31.84,56407006,35126926,25349,11578,13771,17060,0.4043,0.4567,0.5433,0.4289
con2/evi4 --TF--Det,608,all (58) assemblies merged,con2 U evigene full &#8594; Transfuse (filter &#8594; vsearch &#8594; Transrate) &#8594; Detonate,,19619382,33.98,32401388,10319,21051771,31.5,52020770,30968999,21872,11218,10654,17420,0.3917,0.5129,0.4871,0.4442
consensus 2,605,all (58) assemblies merged,consensus 2,,36299636,62.87,267304909,17529,42223476,63.17,303604545,261381069,137494,20908,116586,7730,0.7301,0.1521,0.8479,0.2517
consensus 3,605,all (58) assemblies merged,consensus 3,,34751757,60.19,166216137,16447,39513724,59.12,200967894,161454170,77820,19040,58780,9598,0.6649,0.2447,0.7553,0.3577
consensus 4,605,all (58) assemblies merged,consensus 4,,31551069,54.64,82041903,14442,34762438,52.01,113592972,78830534,42901,16200,26701,12438,0.5657,0.3776,0.6224,0.4529
consensus 5,605,all (58) assemblies merged,consensus 5,,22105443,38.28,26987901,9735,23540602,35.22,49093344,25552742,15085,10301,4784,18337,0.3597,0.6829,0.3171,0.4712
consensus 2 -- Transfuse 1,609,all (58) assemblies merged,consensus 2 &#8594; Transfuse (filter),,34088757,59.04,105126954,16215,38477664,57.57,139215711,100738047,67210,18842,48368,9796,0.6579,0.2803,0.7197,0.3932
consensus 2 -- Transfuse 2,609,all (58) assemblies merged,consensus 2 &#8594; Transfuse (filter &#8594; vsearch),,33987630,58.86,104304871,16204,38397671,57.45,138292501,99894830,66935,18853,48082,9785,0.6583,0.2817,0.7183,0.3945
consensus 2 -- Transfuse 3,609,all (58) assemblies merged,consensus 2 &#8594; Transfuse (filter &#8594; vsearch &#8594; Transrate),,33635536,58.25,93285792,16029,37822995,56.59,126921328,89098333,63175,18603,44572,10035,0.6496,0.2945,0.7055,0.4052
consensus 2 -- TF--Det,610,all (58) assemblies merged,consensus 2 &#8594; Transfuse (filter &#8594; vsearch &#8594; Transrate) &#8594; Detonate,,33343855,57.75,75924861,15705,37384918,55.93,109268716,71883798,50680,18052,32628,10586,0.6304,0.3562,0.6438,0.4552
consensus 2 -- evi4Full,611,all (58) assemblies merged,consensus 2 &#8594; evigene full set,,32875012,56.94,111448910,15521,36537723,54.66,144323922,107786199,59060,17521,41539,11117,0.6118,0.2967,0.7033,0.3996
Trinity k=25 -- Compacta d=0,701,Trinity (k=25),Compacta (d=0.0),,8727028,15.11,4875740,6560,9269640,13.87,13602768,4333128,23638,8015,15623,20623,0.2799,0.3391,0.6609,0.3066
Trinity k=25 -- Compacta d=0.3,701,Trinity (k=25),Compacta (d=0.3),,16173465,28.01,7432843,9565,16868779,25.24,23606308,6737529,31644,11371,20273,17267,0.3971,0.3593,0.6407,0.3773
Trinity k=25 -- Compacta d=1,701,Trinity (k=25),Compacta (d=1.0),,27744888,48.05,36546255,14029,30383160,45.46,64291143,33907983,61190,16375,44815,12263,0.5718,0.2676,0.7324,0.3646
con2--Tf--Det--Compacta d=0,702,consensus 2,Compacta (d=0.0),,8697801,15.06,8972718,6421,9499992,14.21,17670519,8170527,17116,7550,9566,21088,0.2636,0.4411,0.5589,0.33
con2--Tf--Det--Compacta d=0.3,702,consensus 2,Compacta (d=0.3),,9817399,17,9447528,6826,10638594,15.92,19264927,8626333,17796,7961,9835,20677,0.278,0.4473,0.5527,0.3429
con2--Tf--Det--Compacta d=1,702,consensus 2,Compacta (d=1.0),,15018809,26.01,18626096,9005,16430795,24.58,33644905,17214110,24179,10378,13801,18260,0.3624,0.4292,0.5708,0.393
Trinity k=25 -- Grouper (with orphaned reads and min cut filter),705,Trinity (k=25),Grouper (with orphaned reads and min cut filters),,20155642,34.91,5447263,10221,20814541,31.14,25602905,4788364,17859,11376,6483,17262,0.3972,0.637,0.363,0.4893
Trinity k=25 -- Grouper (without orphaned reads and min cut filter),705,Trinity (k=25),Grouper (without orphaned reads or min cut filters),,20223704,35.03,5599137,10267,20906656,31.28,25822841,4916185,18172,11451,6721,17187,0.3999,0.6301,0.3699,0.4893
con2--Tf--Det--Grouper (with orphaned reads and min cut filter),706,consensus 2,Grouper (with orphaned reads and min cut filters),,19053625,33,6838595,8958,19595700,29.32,25892220,6296520,12752,9664,3088,18974,0.3375,0.7578,0.2422,0.467
con2--Tf--Det--Grouper (without orphaned reads and min cut filter),706,consensus 2,Grouper (without orphaned reads or min cut filters),,19104639,33.09,6861508,8978,19656473,29.41,25966147,6309674,12790,9684,3106,18954,0.3382,0.7572,0.2428,0.4675
Trinity k=25 -- Corset d=0; clusters,703,Trinity (k=25),Corset clusters (d=0.0),,30876297,53.47,45298752,15094,34472211,51.57,76175049,41702838,53696,17234,36462,11404,0.6018,0.321,0.679,0.4186
Trinity k=25 -- Corset d=0.3; clusters,703,Trinity (k=25),Corset clusters (d=0.3),,25394528,43.98,15709276,12207,26474309,39.61,41103804,14629495,37977,13917,24060,14721,0.486,0.3665,0.6335,0.4178
Trinity k=25 -- Corset d=1; clusters,703,Trinity (k=25),Corset clusters (d=1.0),,21899663,37.93,4758525,10495,22468383,33.61,26658188,4189805,17410,11665,5745,16973,0.4073,0.67,0.33,0.5066
con2--Tf--Det--Corset d=0; clusters,704,consensus 2,Corset clusters (d=0.0),,30206653,52.31,56067354,14323,33420830,50,86274007,52853177,35241,15985,19256,12653,0.5582,0.4536,0.5464,0.5005
con2--Tf--Det--Corset d=0.3; clusters,704,consensus 2,Corset clusters (d=0.3),,23704652,41.05,15721181,11011,24752064,37.03,39425833,14673769,20152,12117,8035,16521,0.4231,0.6013,0.3987,0.4967
con2--Tf--Det--Corset d=1; clusters,704,consensus 2,Corset clusters (d=1.0),,14006287,24.26,4765014,7133,14401195,21.55,18771301,4370106,10768,7794,2974,20844,0.2722,0.7238,0.2762,0.3956
Trinity k=25 -- Corset; super-clusters,703,Trinity (k=25),Corset superclusters,,8814496,15.27,3155034,5783,9308588,13.93,11969530,2660942,11959,6779,5180,21859,0.2367,0.5669,0.4331,0.334
con2--Tf--Det--Corset; super-clusters,704,consensus 2,Corset superclusters,,5743493,9.95,3262501,3934,6137264,9.18,9005994,2868730,7296,4524,2772,24114,0.158,0.6201,0.3799,0.2518
IDBA_HFk21.fa,idba,IDBA,trimmed reads; k=21,,19001726,32.91,32878505,14368,20303745,30.38,51880231,31576486,84162,16729,67433,11909,0.5842,0.1988,0.8012,0.2966
IDBA_HFk31.fa,idba,IDBA,trimmed reads; k=31,,28606708,49.54,46144470,15541,31740438,47.49,74751178,43010740,77108,18108,59000,10530,0.6323,0.2348,0.7652,0.3425
IDBA_HFk41.fa,idba,IDBA,trimmed reads; k=41,,30816404,53.37,48492385,15730,34405314,51.47,79308789,44903475,76079,18421,57658,10217,0.6432,0.2421,0.7579,0.3518
IDBA_HFk51.fa,idba,IDBA,trimmed reads; k=51,,31589316,54.71,48325977,15729,35262893,52.76,79915293,44652400,75290,18446,56844,10192,0.6441,0.245,0.755,0.355
IDBA_HFk61.fa,idba,IDBA,trimmed reads; k=61,,32038172,55.49,47800047,15727,35775460,53.52,79838219,44062759,74066,18435,55631,10203,0.6437,0.2489,0.7511,0.359
IDBA_HFk71.fa,idba,IDBA,trimmed reads; k=71,,31987660,55.4,45808389,15481,35531351,53.16,77796049,42264698,72146,18090,54056,10548,0.6317,0.2507,0.7493,0.359
IDBA_HTk21.fa,idba,IDBA,normalized trimmed reads; k=21,,19047624,32.99,26087243,13955,20062660,30.02,45134867,25072207,64464,15641,48823,12997,0.5462,0.2426,0.7574,0.336
IDBA_HTk31.fa,idba,IDBA,normalized trimmed reads; k=31,,26642935,46.14,34066447,14818,28872915,43.2,60709382,31836467,59138,16664,42474,11974,0.5819,0.2818,0.7182,0.3797
IDBA_HTk41.fa,idba,IDBA,normalized trimmed reads; k=41,,27903335,48.33,32975395,14864,30378706,45.45,60878730,30500024,57244,16766,40478,11872,0.5854,0.2929,0.7071,0.3904
IDBA_HTk51.fa,idba,IDBA,normalized trimmed reads; k=51,,28156341,48.76,31774125,14740,30622937,45.81,59930466,29307529,55895,16621,39274,12017,0.5804,0.2974,0.7026,0.3932
IDBA_HTk61.fa,idba,IDBA,normalized trimmed reads; k=61,,28064342,48.6,30286298,14542,30551291,45.71,58350640,27799349,54524,16416,38108,12222,0.5732,0.3011,0.6989,0.3948
IDBA_HTk71.fa,idba,IDBA,normalized trimmed reads; k=71,,28025100,48.54,29567642,14419,30456023,45.56,57592742,27136719,53380,16232,37148,12406,0.5668,0.3041,0.6959,0.3958
rnaSPAdes_HFk29.fa,102,rnaSPAdes,trimmed reads; k=29,,28825353,49.92,38536368,13828,31301287,46.83,67361721,36060434,60674,16225,44449,12413,0.5666,0.2674,0.7326,0.3633
rnaSPAdes_HFk33.fa,102,rnaSPAdes,trimmed reads; k=33,,29165815,50.51,37317161,13754,31706245,47.44,66482976,34776731,59963,16122,43841,12516,0.563,0.2689,0.7311,0.3639
rnaSPAdes_HFk49.fa,102,rnaSPAdes,trimmed reads; k=49,,29219039,50.6,32047945,13318,31559122,47.22,61266984,29707862,58849,15655,43194,12983,0.5467,0.266,0.734,0.3579
rnaSPAdes_HFk55.fa,102,rnaSPAdes,trimmed reads; k=55,,29039907,50.29,30273941,13260,31164874,46.63,59313848,28148974,58941,15507,43434,13131,0.5415,0.2631,0.7369,0.3541
rnaSPAdes_HTk29.fa,102,rnaSPAdes,normalized trimmed reads; k=29,,25391341,43.98,25824885,13091,26970930,40.35,51216226,24245296,46071,14903,31168,13735,0.5204,0.3235,0.6765,0.399
rnaSPAdes_HTk33.fa,102,rnaSPAdes,normalized trimmed reads; k=33,,25648035,44.42,24780433,12939,27206019,40.7,50428468,23222449,45397,14753,30644,13885,0.5152,0.325,0.675,0.3985
rnaSPAdes_HTk49.fa,102,rnaSPAdes,normalized trimmed reads; k=49,,25390051,43.97,20803571,12581,26668798,39.9,46193622,19524824,44508,14290,30218,14348,0.499,0.3211,0.6789,0.3907
rnaSPAdes_HTk55.fa,102,rnaSPAdes,normalized trimmed reads; k=55,,25025795,43.34,19642238,12430,26209085,39.21,44668033,18458948,44618,14132,30486,14506,0.4935,0.3167,0.6833,0.3858
SOAPdenovo_HFk21.fa,103,SOAPdenovo-Trans,trimmed reads; k=21,,24748777,42.86,20882978,12559,25868492,38.7,45631755,19763263,57044,14525,42519,14113,0.5072,0.2546,0.7454,0.339
SOAPdenovo_HFk23.fa,103,SOAPdenovo-Trans,trimmed reads; k=23,,24970128,43.25,20356825,12512,26157351,39.13,45326953,19169602,55833,14463,41370,14175,0.505,0.259,0.741,0.3424
SOAPdenovo_HFk25.fa,103,SOAPdenovo-Trans,trimmed reads; k=25,,25056096,43.39,19854310,12537,26219592,39.23,44910406,18690814,54841,14377,40464,14261,0.502,0.2622,0.7378,0.3444
SOAPdenovo_HFk27.fa,103,SOAPdenovo-Trans,trimmed reads; k=27,,25067601,43.41,19347172,12554,26249346,39.27,44414773,18165427,54304,14354,39950,14284,0.5012,0.2643,0.7357,0.3461
SOAPdenovo_HFk29.fa,103,SOAPdenovo-Trans,trimmed reads; k=29,,24776267,42.91,18963122,12640,25941508,38.81,43739389,17797881,53870,14414,39456,14224,0.5033,0.2676,0.7324,0.3494
SOAPdenovo_HFk31.fa,103,SOAPdenovo-Trans,trimmed reads; k=31,,24438307,42.32,18489242,12684,25493273,38.14,42927549,17434276,53848,14444,39404,14194,0.5044,0.2682,0.7318,0.3502
SOAPdenovo_HFk41.fa,103,SOAPdenovo-Trans,trimmed reads; k=41,,21777114,37.72,16511645,12514,22551223,33.74,38288759,15737536,52728,13920,38808,14718,0.4861,0.264,0.736,0.3422
SOAPdenovo_HFk51.fa,103,SOAPdenovo-Trans,trimmed reads; k=51,,17929126,31.05,14612941,12162,18334496,27.43,32542067,14207571,50616,12952,37664,15686,0.4523,0.2559,0.7441,0.3268
SOAPdenovo_HFk61.fa,103,SOAPdenovo-Trans,trimmed reads; k=61,,11367917,19.69,10595179,10901,11458422,17.14,21963096,10504674,37900,11095,26805,17543,0.3874,0.2927,0.7073,0.3335
SOAPdenovo_HFk71.fa,103,SOAPdenovo-Trans,trimmed reads; k=71,,1808385,3.13,1310697,3300,1837688,2.75,3119082,1281394,6410,3407,3003,25231,0.119,0.5315,0.4685,0.1944
SOAPdenovo_HTk21.fa,103,SOAPdenovo-Trans,normalized trimmed reads; k=21,,19923720,34.51,16588071,12012,20441861,30.58,36511791,16069930,45225,13242,31983,15396,0.4624,0.2928,0.7072,0.3586
SOAPdenovo_HTk23.fa,103,SOAPdenovo-Trans,normalized trimmed reads; k=23,,20143836,34.89,16111618,11998,20670507,30.92,36255454,15584947,44622,13152,31470,15486,0.4592,0.2947,0.7053,0.359
SOAPdenovo_HTk25.fa,103,SOAPdenovo-Trans,normalized trimmed reads; k=25,,20045550,34.72,15826449,12011,20550877,30.75,35871999,15321122,44237,13104,31133,15534,0.4576,0.2962,0.7038,0.3596
SOAPdenovo_HTk27.fa,103,SOAPdenovo-Trans,normalized trimmed reads; k=27,,19909396,34.48,15526926,12072,20340958,30.43,35436322,15095364,44291,13098,31193,15540,0.4574,0.2957,0.7043,0.3592
SOAPdenovo_HTk29.fa,103,SOAPdenovo-Trans,normalized trimmed reads; k=29,,19615009,33.97,15236694,12147,20038831,29.98,34851703,14812872,44525,13150,31375,15488,0.4592,0.2953,0.7047,0.3595
SOAPdenovo_HTk31.fa,103,SOAPdenovo-Trans,normalized trimmed reads; k=31,,19163441,33.19,15019519,12158,19587188,29.3,34182960,14595772,45043,13122,31921,15516,0.4582,0.2913,0.7087,0.3562
SOAPdenovo_HTk41.fa,103,SOAPdenovo-Trans,normalized trimmed reads; k=41,,15824730,27.41,14504708,12119,16044971,24,30329438,14284467,49720,12806,36914,15832,0.4472,0.2576,0.7424,0.3269
SOAPdenovo_HTk51.fa,103,SOAPdenovo-Trans,normalized trimmed reads; k=51,,10916879,18.91,13816329,11874,11021959,16.49,24733208,13711249,54029,12213,41816,16425,0.4265,0.226,0.774,0.2955
SOAPdenovo_HTk61.fa,103,SOAPdenovo-Trans,normalized trimmed reads; k=61,,3904993,6.76,7338786,9366,3973793,5.95,11243779,7269986,35046,9607,25439,19031,0.3355,0.2741,0.7259,0.3017
SOAPdenovo_HTk71.fa,103,SOAPdenovo-Trans,normalized trimmed reads; k=71,,501,0,460,2,730,0,961,231,4,3,1,28635,0.0001,0.75,0.25,0.0002
TransLiG_HFk21.fa,104,TransLiG,trimmed reads; k=21,,24525735,42.48,41110453,13269,26164854,39.14,65636188,39471334,34632,14582,20050,14056,0.5092,0.4211,0.5789,0.4609
TransLiG_HFk23.fa,104,TransLiG,trimmed reads; k=23,,27097964,46.93,37569623,13487,29077710,43.5,64667587,35589877,31872,14741,17131,13897,0.5147,0.4625,0.5375,0.4872
TransLiG_HFk25.fa,104,TransLiG,trimmed reads; k=25,,28074492,48.62,35901874,13471,30265195,45.28,63976366,33711171,30218,14692,15526,13946,0.513,0.4862,0.5138,0.4993
TransLiG_HFk27.fa,104,TransLiG,trimmed reads; k=27,,28374048,49.14,34278754,13422,30654964,45.86,62652802,31997838,28462,14550,13912,14088,0.5081,0.5112,0.4888,0.5096
TransLiG_HFk29.fa,104,TransLiG,trimmed reads; k=29,,28699786,49.71,33047075,13359,31095348,46.52,61746861,30651513,27279,14563,12716,14075,0.5085,0.5339,0.4661,0.5209
TransLiG_HFk31.fa,104,TransLiG,trimmed reads; k=31,,28806343,49.89,31980506,13291,31149004,46.6,60786849,29637845,26432,14439,11993,14199,0.5042,0.5463,0.4537,0.5244
TransLiG_HTk21.fa,104,TransLiG,normalized trimmed reads; k=21,,21639309,37.48,29402558,12412,22648753,33.88,51041867,28393114,27310,13221,14089,15417,0.4617,0.4841,0.5159,0.4726
TransLiG_HTk23.fa,104,TransLiG,normalized trimmed reads; k=23,,23612021,40.89,25427437,12474,24776266,37.07,49039458,24263192,24754,13231,11523,15407,0.462,0.5345,0.4655,0.4956
TransLiG_HTk25.fa,104,TransLiG,normalized trimmed reads; k=25,,24254139,42.01,23923343,12370,25502595,38.15,48177482,22674887,23567,13064,10503,15574,0.4562,0.5543,0.4457,0.5005
TransLiG_HTk27.fa,104,TransLiG,normalized trimmed reads; k=27,,24138100,41.8,21889973,12208,25392628,37.99,46028073,20635445,22333,12836,9497,15802,0.4482,0.5748,0.4252,0.5037
TransLiG_HTk29.fa,104,TransLiG,normalized trimmed reads; k=29,,24377143,42.22,20738305,12160,25573721,38.26,45115448,19541727,21438,12721,8717,15917,0.4442,0.5934,0.4066,0.5081
TransLiG_HTk31.fa,104,TransLiG,normalized trimmed reads; k=31,,24178588,41.87,19685643,11991,25330744,37.9,43864231,18533487,20611,12544,8067,16094,0.438,0.6086,0.3914,0.5094
Trinity_HTk21.fa,105,Trinity,Trinity's <em>in silico</em> normalization of trimmed reads; k=21,,29491010,51.08,43277714,14917,32566212,48.72,72768724,40202512,84110,17743,66367,10895,0.6196,0.2109,0.7891,0.3147
Trinity_HTk23.fa,105,Trinity,Trinity's <em>in silico</em> normalization of normalized trimmed reads; k=23,,30095400,52.12,44195403,15034,33269459,49.77,74290803,41021344,81923,17786,64137,10852,0.6211,0.2171,0.7829,0.3217
Trinity_HTk25.fa,105,Trinity,Trinity's <em>in silico</em> normalization of normalized trimmed reads; k=25,,31002169,53.69,52151482,15492,34775147,52.03,83153651,48378504,84970,18357,66613,10281,0.641,0.216,0.784,0.3232
Trinity_HTk27.fa,105,Trinity,Trinity's <em>in silico</em> normalization of normalized trimmed reads; k=27,,30904175,53.52,51202528,15476,34625348,51.8,82106703,47481355,83183,18325,64858,10313,0.6399,0.2203,0.7797,0.3278
Trinity_HTk29.fa,105,Trinity,Trinity's <em>in silico</em> normalization of normalized trimmed reads; k=29,,30591599,52.98,49525905,15389,34280541,51.29,80117504,45836963,80395,18205,62190,10433,0.6357,0.2264,0.7736,0.3339
Trinity_HTk31.fa,105,Trinity,Trinity's <em>in silico</em> normalization of normalized trimmed reads; k=31,,30217010,52.33,47321430,15281,33847141,50.64,77538440,43691299,77642,18069,59573,10569,0.6309,0.2327,0.7673,0.34
median,106,median,of all single k-mer assemblies,,25061849,43,25673319,13015,26234469,39,50735168,24667700,53054,14538,37886,14101,0.507629723,0.286551611,0.713448389,0.358770629
cat 15 cluster ORFs @ 90% aa identity,507,15 assemblies merged,DRAP (cluster ORFs at 90% aa identity),,31083281,53.83,147588594,15809,34254898,51.25,178671875,144416977,214617,18935,195682,9703,0.6612,0.0882,0.9118,0.1557
cat 15 90%aa --> 95% nt identity,507,15 assemblies merged,DRAP (cluster ORFs at 90% aa identity &#8594; cluster contigs at 95% nt identity),,29396062,50.91,73814152,14590,31904482,47.73,103210214,71305732,97584,17253,80331,11385,0.6025,0.1768,0.8232,0.2734
cat 15 90%aa --> 95% nt identity --> tpm>0,507,15 assemblies merged,DRAP (cluster ORFs at 90% aa identity &#8594; cluster contigs at 95% nt identity &#8594; TPM>0 (used Salmon; original method used eXpress),,27759919,48.08,58209550,13951,29897161,44.73,85969469,56072308,73680,16236,57444,12402,0.5669,0.2204,0.7796,0.3174
cat 15 90%aa --> 95% nt identity --> tpm>10,507,15 assemblies merged,DRAP (cluster ORFs at 90% aa identity &#8594; cluster contigs at 95% nt identity &#8594; TPM>10 (used Salmon; original method used eXpress),,9884655,17.12,5718475,5422,9948337,14.88,15603130,5654793,8468,5612,2856,23026,0.196,0.6627,0.3373,0.3025
cat 15 90%aa --> 95% nt identity --> tpm>1,507,15 assemblies merged,DRAP (cluster ORFs at 90% aa identity &#8594; cluster contigs at 95% nt identity &#8594; TPM>1 (used Salmon; original method used eXpress),,24332798,42.14,37592773,12791,26001085,38.9,61925571,35924486,60396,14845,45551,13793,0.5184,0.2458,0.7542,0.3335
cat 15 90%aa --> 95% nt identity --> tpm>3,507,15 assemblies merged,DRAP (cluster ORFs at 90% aa identity &#8594; cluster contigs at 95% nt identity &#8594; TPM>3 (used Salmon; original method used eXpress),,19477920,33.73,19144703,10429,20254510,30.3,38622623,18368113,38201,11798,26403,16840,0.412,0.3088,0.6912,0.353
cat 15 90%aa --> 95% nt identity --> tpm>5,507,15 assemblies merged,DRAP (cluster ORFs at 90% aa identity &#8594; cluster contigs at 95% nt identity &#8594; TPM>5 (used Salmon; original method used eXpress),,15731101,27.24,12205231,8601,16150077,24.16,27936332,11786255,23152,9486,13666,19152,0.3312,0.4097,0.5903,0.3663
cat 15 90%aa --> 95% nt identity --> tpm>0 -->TR 3/4,507,15 assemblies merged,DRAP (cluster ORFs at 90% aa identity &#8594; cluster contigs at 95% nt identity &#8594; TPM>0 &#8594;  Transrate contigs passing 3 of 4 criteria (used Salmon TPM>0; original method used eXpress FPKM>1 &amp;contigs meeting min. threshold based on all 4 crieteria),,25879579,44.82,38784556,13075,27711277,41.46,64664135,36952858,60372,15197,45175,13441,0.5307,0.2517,0.7483,0.3415
cat 15 90%aa --> 95% nt identity --> tpm>1 -->TR 3/4,507,15 assemblies merged,DRAP (cluster ORFs at 90% aa identity &#8594; cluster contigs at 95% nt identity &#8594; TPM>1 &#8594;  Transrate contigs passing 3 of 4 criteria (used Salmon TPM>1; original method used eXpress FPKM>1 &amp;contigs meeting min. threshold based on all 4 crieteria),,23597739,40.87,31318172,12367,25134048,37.6,54915911,29781863,54432,14353,40079,14285,0.5012,0.2637,0.7363,0.3456
cat 15 90%aa --> 95% nt identity --> tpm>0 -->TR 4/4,507,15 assemblies merged,DRAP (cluster ORFs at 90% aa identity &#8594; cluster contigs at 95% nt identity &#8594; TPM>0 &#8594;  Transrate contigs passing 4 of 4 criteria (used Salmon TPM>0; original method used eXpress FPKM>1),,13320939,23.07,11696363,8826,14191317,21.23,25017302,10825985,20850,9906,10944,18732,0.3459,0.4751,0.5249,0.4003
cat 15 90%aa --> 95% nt identity --> tpm>1 -->TR 4/4,507,15 assemblies merged,DRAP (cluster ORFs at 90% aa identity &#8594; cluster contigs at 95% nt identity &#8594; TPM>1 &#8594;  Transrate contigs passing 4 of 4 criteria (used Salmon TPM>1; original method used eXpress FPKM>1),,14950014,25.89,11998512,8880,15758883,23.58,26948526,11189643,19750,9857,9893,18781,0.3442,0.4991,0.5009,0.4074
cat 4 cluster ORFs @ 90% aa identity,407,4 assemblies merged,DRAP (cluster ORFs at 90% aa identity),,30191658,52.29,81257604,15000,33098344,49.52,111449262,78350918,125085,17922,107163,10716,0.6258,0.1433,0.8567,0.2332
cat 4 90%aa --> 95% nt identity,407,4 assemblies merged,DRAP (cluster ORFs at 90% aa identity &#8594; cluster contigs at 95% nt identity),,28786541,49.86,51241706,13977,31132735,46.58,80028247,48895512,83957,16530,67427,12108,0.5772,0.1969,0.8031,0.2936
cat 4 90%aa --> 95% nt identity --> tpm>0,407,4 assemblies merged,DRAP (cluster ORFs at 90% aa identity  &#8594; cluster contigs at 95% nt identity &#8594; TPM>0 (used Salmon; original method used eXpress),,27287807,47.26,41984851,13382,29342332,43.9,69272658,39930326,66583,15604,50979,13034,0.5449,0.2344,0.7656,0.3277
cat 4 90%aa --> 95% nt identity --> tpm>10,407,4 assemblies merged,DRAP (cluster ORFs at 90% aa identity &#8594; cluster contigs at 95% nt identity &#8594; TPM>10 (used Salmon; original method used eXpress),,7369753,12.76,3263246,4029,7402313,11.07,10632999,3230686,5024,4147,877,24491,0.1448,0.8254,0.1746,0.2464
cat 4 90%aa --> 95% nt identity --> tpm>1,407,4 assemblies merged,DRAP (cluster ORFs at 90% aa identity &#8594; cluster contigs at 95% nt identity &#8594; TPM>1 (used Salmon; original method used eXpress),,22939273,39.73,25651195,11953,24347438,36.43,48590468,24243030,52538,13807,38731,14831,0.4821,0.2628,0.7372,0.3402
cat 4 90%aa --> 95% nt identity --> tpm>3,407,4 assemblies merged,DRAP (cluster ORFs at 90% aa identity &#8594; cluster contigs at 95% nt identity &#8594; TPM>3 (used Salmon; original method used eXpress),,17228718,29.84,12582220,9254,17811323,26.65,29810938,11999615,28743,10380,18363,18258,0.3625,0.3611,0.6389,0.3618
cat 4 90%aa --> 95% nt identity --> tpm>5,407,4 assemblies merged,DRAP (cluster ORFs at 90% aa identity &#8594; cluster contigs at 95% nt identity &#8594; TPM>5 (used Salmon; original method used eXpress),,12912222,22.36,7399946,7005,13201304,19.75,20312168,7110864,14249,7548,6701,21090,0.2636,0.5297,0.4703,0.352
cat 4 90%aa --> 95% nt identity --> tpm>0 -->TR 3/4,407,4 assemblies merged,DRAP (cluster ORFs at 90% aa identity &#8594; cluster contigs at 95% nt identity &#8594; TPM>0 &#8594;  Transrate contigs passing 3 of 4 criteria (used Salmon TPM>0; original method used eXpress FPKM>1 &amp;contigs meeting min. threshold based on all 4 crieteria),,26376156,45.68,33980323,12948,28220370,42.22,60356479,32136109,58806,15060,43746,13578,0.5259,0.2561,0.7439,0.3444
cat 4 90%aa --> 95% nt identity --> tpm>1 -->TR 3/4,407,4 assemblies merged,DRAP (cluster ORFs at 90% aa identity &#8594; cluster contigs at 95% nt identity &#8594; TPM>1 &#8594;  Transrate contigs passing 3 of 4 criteria (used Salmon TPM>1; original method used eXpress FPKM>1 &amp;contigs meeting min. threshold based on all 4 crieteria),,22361006,38.73,22304088,11566,23657930,35.39,44665094,21007164,47413,13346,34067,15292,0.466,0.2815,0.7185,0.351
cat 4 90%aa --> 95% nt identity --> tpm>0 -->TR 4/4,407,4 assemblies merged,DRAP (cluster ORFs at 90% aa identity &#8594; cluster contigs at 95% nt identity &#8594; TPM>0 &#8594;  Transrate contigs passing 4 of 4 criteria (used Salmon TPM>0; original method used eXpress FPKM>1),,16675664,28.88,13485028,9518,17688156,26.46,30160692,12472536,22340,10686,11654,17952,0.3731,0.4783,0.5217,0.4192
cat 4 90%aa --> 95% nt identity --> tpm>1 -->TR 4/4,407,4 assemblies merged,DRAP (cluster ORFs at 90% aa identity &#8594; cluster contigs at 95% nt identity &#8594; TPM>1 &#8594;  Transrate contigs passing 4 of 4 criteria (used Salmon TPM>1; original method used eXpress FPKM>1),,15418408,26.7,8831941,8090,16124656,24.12,24250349,8125693,15106,8800,6306,19838,0.3073,0.5825,0.4175,0.4023
