ContigSetID,cbID,contigSet,methodHTML,methodFails,transcriptBaseCoverage,transcriptBaseCoveragePercent,transcriptsPartial,contigBaseCoverage,contigBaseCoveragePercent,contigAssembledBases,contigAdditionalBases,contigsAssembled,contigsTP,contigsFP,contigsFN,contigSensitivity,contigSpecificity,contigFDR,contigF1
simulation reference,107,simulated reads,simulated with FluxSimulator,,45533676,100,28872,22991161,100,22991161,0,43814,43814,0,0,1,1,0,1
HISAT2 -- StringTie1,107,genome-guided assembly,HISAT2 &#8594; Stringtie,,15510629,34.06408259,17587,18894109,82.17988209,24014364,5120255,35699,27512,8187,16302,0.627927147,0.770665845,0.229334155,0.692012627
HISAT2 -- Scallop,107,genome-guided assembly,HISAT2 &#8594; Scallop,,12326129,27.07035777,14305,14085251,61.26376567,21865663,7780412,32951,19808,13143,24006,0.452092938,0.601135019,0.398864981,0.516068521
HISAT2 -- Strawberry,107,genome-guided assembly,HISAT2 &#8594; Strawberry,,12704744,27.90186323,13708,14240616,61.93952537,17044984,2804368,22321,18148,4173,25666,0.414205505,0.81304601,0.18695399,0.548816814
HISAT2 -- Traph,107,genome-guided assembly,HISAT2 &#8594; Traph,,11424767,25.09080752,11422,11803949,51.34124806,49876540,38072591,25072,14667,10405,29147,0.334756014,0.584995214,0.415004786,0.425833987
Tophat2 -- Bayesembler,107,genome-guided assembly,Tophat2 &#8594; Bayesembler,,11308350,24.83513521,12839,12151190,52.85157196,18538069,6386879,19527,17212,2315,26602,0.39284247,0.881446203,0.118553797,0.543471054
Tophat2 -- TransComb,107,genome-guided assembly,Tophat2 &#8594; Transcomb,,17021928,37.3831623,19766,17258982,75.06790109,27101831,9842849,36127,27504,8623,16310,0.627744557,0.761314252,0.238685748,0.688107479
evi ok,201,Trinity (k=25),evigene ok set,,8909747,19.5673791,10764,9375407,40.77831041,11195263,1819856,15241,12744,2497,31070,0.290865933,0.836165606,0.163834394,0.431597663
evi full,201,Trinity (k=25),evigene ok + alt/cull set,,10950647,24.0495562,13163,11108168,48.31495025,18753771,7645603,23310,16405,6905,27409,0.3744237,0.703775204,0.296224796,0.488796854
evi4F --> TF1,202,Trinity (k=25),evigene full set &#8594; Transfuse (filter),,10462931,22.97844567,11581,10425866,45.34727933,16346004,5920138,17459,13751,3708,30063,0.313849455,0.787616702,0.212383298,0.4488437
evi4F --> TF2,202,Trinity (k=25),evigene full set &#8594; Transfuse (filter &#8594; vsearch),,10486513,23.03023591,11624,10451596,45.4591919,16344185,5892589,17455,13829,3626,29985,0.315629707,0.792265826,0.207734174,0.451419152
evi4F --> TF3,202,Trinity (k=25),evigene full set &#8594; Transfuse (filter &#8594; vsearch &#8594; Transrate),,10448358,22.94644078,11543,10414795,45.29912604,16142000,5727205,17197,13713,3484,30101,0.312982152,0.797406524,0.202593476,0.449525495
evi4 --> TF --> Det,203,Trinity (k=25),evigene full set &#8594; Transfuse (filter &#8594; vsearch &#8594; Transrate) &#8594; Detonate,,10182661,22.36292321,11126,10237560,44.52824283,14685658,4448098,15794,13119,2675,30695,0.299424841,0.830631886,0.169368114,0.440175815
transfuse 1 (filter),204,Trinity (k=25),Transfuse (filter),,10630432,23.34630747,11970,10652227,46.33183596,21156319,10504092,24184,14354,9830,29460,0.327612179,0.593532914,0.406467086,0.422188888
transfuse 2 (vsearch),204,Trinity (k=25),Transfuse (filter &#8594; vsearch),,10631888,23.3495051,11976,10652704,46.33391067,17069770,6417066,18524,14324,4200,29490,0.326927466,0.773267113,0.226732887,0.459559177
transfuse 3 (transrate),204,Trinity (k=25),Transfuse (filter &#8594; vsearch &#8594; Transrate),,10606675,23.2941329,11921,10623586,46.207262,16864628,6241042,18276,14228,4048,29586,0.324736386,0.778507332,0.221492668,0.458302464
TF3 --> Det,205,Trinity (k=25),Transfuse (filter &#8594; vsearch &#8594; Transrate) &#8594; Detonate,,10355516,22.74254334,11519,10458575,45.48954705,15320813,4862238,16827,13651,3176,30163,0.311567079,0.81125572,0.18874428,0.450223446
Detonate,206,Trinity (k=25),Detonate,,10581188,23.23815894,12011,10737737,46.7037615,21935015,11197278,26421,14515,11906,29299,0.331286803,0.549373604,0.450626396,0.413326689
evi ok,301,TransLiG (k=25),evigene ok set,,9047627,19.87018795,10883,9253930,40.24994649,13210336,3956406,13569,12434,1135,31380,0.283790569,0.916353453,0.083646547,0.433368768
evi full,301,TransLiG (k=25),evigene ok + alt/cull set,,12818036,28.15067248,14859,12415478,54.00109198,30668006,18252528,26030,18125,7905,25689,0.413680559,0.696311948,0.303688052,0.519013802
evi4F --> TF1,302,TransLiG (k=25),evigene full set &#8594; Transfuse (filter),,12527559,27.51273365,14095,12087113,52.5728692,27012051,14924938,21984,16803,5181,27011,0.383507555,0.764328603,0.235671397,0.510745007
evi4F --> TF2,302,TransLiG (k=25),evigene full set &#8594; Transfuse (filter &#8594; vsearch),,12535953,27.53116836,14091,12117911,52.70682503,26874699,14756788,21840,16842,4998,26972,0.384397681,0.771153846,0.228846154,0.513053279
evi4F --> TF3,302,TransLiG (k=25),evigene full set &#8594; Transfuse (filter &#8594; vsearch &#8594; Transrate),,12457910,27.35977214,13923,12042010,52.37669381,26226130,14184120,21250,16583,4667,27231,0.378486329,0.780376471,0.219623529,0.509744252
evi4 --> TF --> Det,303,TransLiG (k=25),evigene full set &#8594; Transfuse (filter &#8594; vsearch &#8594; Transrate) &#8594; Detonate,,12045652,26.45438071,13071,11664584,50.73508032,21776468,10111884,17867,15195,2672,28619,0.346806957,0.850450551,0.149549449,0.492696292
transfuse 1 (filter),304,TransLiG (k=25),Transfuse (filter),,12964942,28.47330402,15133,12659222,55.06125593,36625365,23966143,31948,18909,13039,24905,0.431574383,0.591868036,0.408131964,0.499168449
transfuse 2 (vsearch),304,TransLiG (k=25),Transfuse (filter &#8594; vsearch),,12940234,28.41904089,15108,12638353,54.97048627,31017136,18378783,25989,18679,7310,25135,0.426324919,0.718727154,0.281272846,0.535191897
transfuse 3 (transrate),304,TransLiG (k=25),Transfuse (filter &#8594; vsearch &#8594; Transrate),,12849116,28.21892966,14867,12533755,54.51553751,29727011,17193256,24931,18270,6661,25544,0.416990003,0.73282259,0.26717741,0.531529566
TF3 --> Det,305,TransLiG (k=25),Transfuse (filter &#8594; vsearch &#8594; Transrate) &#8594; Detonate,,12354259,27.13213622,13788,12058740,52.4494609,23357503,11298763,19970,16402,3568,27412,0.374355229,0.821331998,0.178668002,0.514298257
Detonate,306,TransLiG (k=25),Detonate,,12721343,27.93831757,14663,12455870,54.17677689,32547386,20091516,30483,17848,12635,25966,0.407358379,0.585506676,0.414493324,0.480450085
"4 merger, IDBA k=1/3RL, rnaSPAdes def, Trinity k-25, TransLiG k=25",401,4 assemblies merged,with trimmed reads: IDBA k=31; rnaSPAdes k=49; TransLiG k=25; with assembly <em>in-silico normalization</em>: Trinity k=25,,16618862,36.49795813,24081,17619231,76.63480326,166411924,148792693,360592,40971,319621,2843,0.935112065,0.113621489,0.886378511,0.202623106
evi ok,402,4 assemblies merged,evigene ok set,,10076527,22.12983419,14734,10877244,47.31054687,16303428,5426184,30396,19683,10713,24131,0.449239969,0.64755231,0.35244769,0.530467592
evi full,402,4 assemblies merged,evigene ok + alt/cull set,,15787581,34.67231813,20869,15766064,68.57445781,71803564,56037500,92347,30612,61735,13202,0.698680787,0.331488841,0.668511159,0.449644171
evi4F --> TF1,403,4 assemblies merged,evigene full set &#8594; Transfuse (filter),,13877010,30.47636655,15534,13412371,58.33707571,37647538,24235167,33522,20023,13499,23791,0.457000046,0.59730923,0.40269077,0.517818351
evi4F --> TF2,403,4 assemblies merged,evigene full set &#8594; Transfuse (filter &#8594; vsearch),,13891915,30.50910056,15540,13453026,58.51390454,36824739,23371713,32439,20130,12309,23684,0.459442187,0.620549339,0.379450661,0.527979227
evi4F --> TF3,403,4 assemblies merged,evigene full set &#8594; Transfuse (filter &#8594; vsearch &#8594; Transrate),,13683970,30.05241659,15173,13275221,57.74054212,34339590,21064369,30085,19536,10549,24278,0.445884877,0.649360146,0.350639854,0.528721634
evi4 --> TF --> Det,404,4 assemblies merged,evigene full set &#8594; Transfuse (filter &#8594; vsearch &#8594; Transrate) &#8594; Detonate,,13160365,28.90248747,14285,12887069,56.05227592,27671907,14784838,24722,18048,6674,25766,0.41192313,0.730038023,0.269961977,0.526672114
transfuse 1 (filter),405,4 assemblies merged,Transfuse (filter),,13654998,29.98878896,15676,13463388,58.55897403,43057968,29594580,41143,20773,20370,23041,0.474117862,0.504897552,0.495102448,0.489023859
transfuse 2 (vsearch),405,4 assemblies merged,Transfuse (filter &#8594; vsearch),,13674877,30.03244675,15707,13490176,58.67548838,35982347,22492171,33210,20737,12473,23077,0.473296207,0.624420355,0.375579645,0.538455546
transfuse 3 (transrate),405,4 assemblies merged,Transfuse (filter &#8594; vsearch &#8594; Transrate),,13449779,29.53809176,15341,13313809,57.90838053,32773186,19459377,30366,20078,10288,23736,0.458255352,0.661200026,0.338799974,0.541331895
TF3 --> Det,406,4 assemblies merged,Transfuse (filter &#8594; vsearch &#8594; Transrate) &#8594; Detonate,,12936531,28.41090844,14306,12877458,56.01047289,27350471,14473013,25393,18349,7044,25465,0.41879308,0.722600717,0.277399283,0.53026428
ORP 1 (orthomerged),408,4 assemblies merged,ORP (orthomerged),,12866069,28.25616144,20590,15190757,66.07216138,49903008,34712251,136861,36524,100337,7290,0.833614826,0.266869305,0.733130695,0.404306074
ORP 2 (cd-hit),408,4 assemblies merged,ORP (orthomerged &#8594; cd-hit c=1; original method used c=0.98),,12851047,28.22317047,20569,15137767,65.84168151,41923612,26785845,106349,36210,70139,7604,0.826448167,0.34048275,0.65951725,0.482275927
ORP 3 (High exp),408,4 assemblies merged,ORP (orthomerged &#8594; cd-hit &#8594; high expression TPM&#8805;0.05; original method used TPM&#8805;1),,11568823,25.40717995,10532,12294598,53.47532471,22662560,10367962,28742,19948,8794,23866,0.455288264,0.694036601,0.305963399,0.549864932
ORP 4 (with blast),408,4 assemblies merged,ORP (orthomerged &#8594; cd-hit &#8594; high expression &#8594;  blast recovery of low exp.),,12424934,27.28735101,18275,14120045,61.41510209,34645530,20525485,69425,30077,39348,13737,0.686470078,0.433230104,0.566769896,0.531212745
"15 merger: IDBA 1/3, 1/2; rnaSPAdes def, Soap 1/3,1/2; TransLiG k=25,31 + norm; Trinity k=25",501,15 assemblies merged,with trimmed reads: IDBA k=31 41; rnaSPAdes k=49; Soap 25 41; TransLiG k=25 31 <br />with BBNorm normalized reads: IDBA k=31 41; rnaSPAdes k=49; Soap 25 41; TransLiG k=25 31 <br />with assembly <em>in-silico normalization</em>: Trinity k=25,,17876188,39.25926824,25120,18365203,79.8794067,553825222,535460019,1165738,42354,1123384,1460,0.966677318,0.036332349,0.963667651,0.070032541
evi ok,502,15 assemblies merged,evigene ok set,,10067025,22.10896612,17367,11262830,48.98765225,19235237,7972407,49494,25606,23888,18208,0.58442507,0.517355639,0.482644361,0.548848973
evi full,502,15 assemblies merged,evigene ok + alt/cull set,,17561153,38.5673957,24690,17815947,77.49041904,178398422,160582475,216620,40195,176425,3619,0.917400831,0.18555535,0.81444465,0.308677054
evi4F --> TF1,503,15 assemblies merged,evigene full set &#8594; Transfuse (filter),,14873834,32.66556823,17379,14673535,63.82250553,59035785,44362250,52781,24691,28090,19123,0.563541334,0.467800913,0.532199087,0.511227289
evi4F --> TF2,503,15 assemblies merged,evigene full set &#8594; Transfuse (filter &#8594; vsearch),,14906697,32.73774118,17488,14751478,64.16151842,57862482,43111004,51334,25048,26286,18766,0.571689414,0.487941715,0.512058285,0.526506075
evi4F --> TF3,503,15 assemblies merged,evigene full set &#8594; Transfuse (filter &#8594; vsearch &#8594; Transrate),,14502719,31.8505341,17004,14474271,62.95580723,48783132,34308861,44308,24169,20139,19645,0.551627334,0.545477115,0.454522885,0.548534986
evi4 --> TF --> Det,504,15 assemblies merged,evigene full set &#8594; Transfuse (filter &#8594; vsearch &#8594; Transrate) &#8594; Detonate,,14055644,30.86867838,16330,14139222,61.49851241,40266511,26127289,37522,22922,14600,20892,0.523166111,0.610894942,0.389105058,0.563637258
transfuse 1 (filter),505,15 assemblies merged,Transfuse (filter),,15918440,34.95970762,22728,16698248,72.6289899,79620933,62922685,102980,35887,67093,7927,0.819076094,0.348485143,0.651514857,0.48894369
transfuse 2 (vsearch),505,15 assemblies merged,Transfuse (filter &#8594; vsearch),,15951395,35.03208263,22837,16794087,73.0458414,63508757,46714670,82194,36263,45931,7551,0.827657826,0.441187921,0.558812079,0.575566631
transfuse 3 (transrate),505,15 assemblies merged,Transfuse (filter &#8594; vsearch &#8594; Transrate),,15406709,33.83585591,22232,16406737,71.3610635,49897875,33491138,68889,35070,33819,8744,0.800429087,0.509079824,0.490920176,0.622343682
TF3 --> Det,506,15 assemblies merged,Transfuse (filter &#8594; vsearch &#8594; Transrate) &#8594; Detonate,,14981514,32.90205254,21671,16133583,70.17298083,43426042,27292459,61752,34054,27698,9760,0.777240152,0.55146392,0.44853608,0.645169846
ORP 1 (orthomerged),508,15 assemblies merged,ORP (orthomerged),,12114163,26.60484297,20036,14605970,63.52863172,48133719,33527749,120179,35843,84336,7971,0.818071849,0.298246782,0.701753218,0.437128414
ORP 2 (cd-hit),508,15 assemblies merged,ORP (orthomerged &#8594; cd-hit c=1; original method used c=0.98),,12102508,26.57924653,20011,14554066,63.3028754,41786819,27232753,96833,35564,61269,8250,0.811704022,0.367271488,0.632728512,0.505719994
ORP 3 (High exp),508,15 assemblies merged,ORP (orthomerged &#8594; cd-hit &#8594; high expression TPM&#8805;0.05; original method used TPM&#8805;1),,11656727,25.60023267,19176,13402189,58.29278913,28961994,15559805,51140,29916,21224,13898,0.682795454,0.584982401,0.415017599,0.630115635
ORP 4 (with blast),508,15 assemblies merged,ORP (orthomerged &#8594; cd-hit &#8594; high expression &#8594;  blast recovery of low exp.),,12004178,26.36329648,19704,14200029,61.76299231,37311102,23111073,75743,33704,42039,10110,0.769251837,0.444978414,0.555021586,0.563814749
All + norm,601,all (82) assemblies merged,with trimmed reads: IDBA k=21-141 step 10; rnaSPAdes k=33 49 55 77; Soap k=21-31 step 2 &amp; k=41-121 step 10; TransLiG k=21-31 step 2 <br />with BBNorm normalized reads: IDBA k=21-141 step 10; rnaSPAdes k=33 49 55 77; Soap k=21-31 step 2 &amp; k=41-121 step 10; TransLiG k=21-31 step 2 <br />with assembly <em>in-silico normalization</em>: Trinity k=21-31 step 2,,18959273,41.63791432,25947,18864538,82.05126309,3931509280,3912644742,12624001,42969,12581032,845,0.980713927,0.003403754,0.996596246,0.006783964
evigene full,602,all (82) assemblies merged,evigene ok + alt/cull set,,18808829,41.30751271,25761,18686366,81.2763044,624254752,605568386,875202,42513,832689,1301,0.970306295,0.048575072,0.951424928,0.09251852
evi4F --> TF1,603,all (82) assemblies merged,evigene full set &#8594; Transfuse (filter),,15603284,34.26756935,20709,15787112,68.66600604,85004338,69217226,89277,31377,57900,12437,0.71614096,0.351456702,0.648543298,0.471511973
evi4F --> TF2,603,all (82) assemblies merged,evigene full set &#8594; Transfuse (filter &#8594; vsearch),,15644018,34.35702841,20836,15900266,69.15816909,83193765,67293499,87311,31926,55385,11888,0.728671201,0.365658394,0.634341606,0.486955195
evi4F --> TF3,603,all (82) assemblies merged,evigene full set &#8594; Transfuse (filter &#8594; vsearch &#8594; Transrate),,14880544,32.68030457,19977,15409758,67.02470571,56953004,41543246,62826,30365,32461,13449,0.693043319,0.483319008,0.516680992,0.569486122
evi4 --> TF --> Det,604,all (82) assemblies merged,evigene full set &#8594; Transfuse (filter &#8594; vsearch &#8594; Transrate) &#8594; Detonate,,14458646,31.753742,19345,15112242,65.73066058,48295049,33182807,54846,29224,25622,14590,0.667001415,0.532837399,0.467162601,0.592418407
con2-eviFull Best evi set,606,all (82) assemblies merged,intersection of consensus 2 and evigene full sets,,16306950,35.81294425,21644,16130122,70.15792721,105637838,89507716,103500,33390,70110,10424,0.762085178,0.322608696,0.677391304,0.453317404
con2/evi4 -- Transfuse 1,607,all (82) assemblies merged,con2 U evigene full &#8594; Transfuse (filter),,14922286,32.77197738,19095,14803079,64.38595685,55853108,41050029,48987,27389,21598,16425,0.625119825,0.559107518,0.440892482,0.590273812
con2/evi4 -- Transfuse 2,607,all (82) assemblies merged,con2 U evigene full &#8594; Transfuse (filter &#8594; vsearch),,14924461,32.77675407,19122,14817714,64.44961174,55853108,41035394,48987,27427,21560,16387,0.625987127,0.559883234,0.440116766,0.591092768
con2/evi4 -- Transfuse 3,607,all (82) assemblies merged,con2 U evigene full &#8594; Transfuse (filter &#8594; vsearch &#8594; Transrate),,14698623,32.2807739,18864,14671890,63.8153506,51336510,36664620,46032,26940,19092,16874,0.614871959,0.585245047,0.414754953,0.599692808
con2/evi4 --TF--Det,608,all (82) assemblies merged,con2 U evigene full &#8594; Transfuse (filter &#8594; vsearch &#8594; Transrate) &#8594; Detonate,,14253146,31.30242768,18198,14385959,62.5716944,43182123,28796164,40483,25811,14672,18003,0.589103939,0.637576267,0.362423733,0.61238241
consensus 2,605,all (82) assemblies merged,consensus 2,,18065348,39.67469703,24865,18398522,80.02432761,153937708,135539186,166663,41506,125157,2308,0.947322774,0.249041479,0.750958521,0.394399388
consensus 3,605,all (82) assemblies merged,consensus 3,,17074909,37.49951794,23725,17736703,77.14574745,95701113,77964410,102359,39139,63220,4675,0.893298946,0.382369894,0.617630106,0.535516135
consensus 4,605,all (82) assemblies merged,consensus 4,,15065233,33.08591426,18481,15173983,65.99920291,56915450,41741467,47501,26421,21080,17393,0.60302643,0.556219869,0.443780131,0.578678202
consensus 5,605,all (82) assemblies merged,consensus 5,,11890827,26.11435765,13948,11899501,51.75685125,29964283,18064782,22036,17324,4712,26490,0.395398731,0.786168089,0.213831911,0.526165528
consensus 2 -- Transfuse 1,609,all (82) assemblies merged,consensus 2 &#8594; Transfuse (filter),,16404172,36.02646094,22791,17115326,74.44306966,68026303,50910977,77352,36403,40949,7411,0.830853152,0.470614852,0.529385148,0.600878134
consensus 2 -- Transfuse 2,609,all (82) assemblies merged,consensus 2 &#8594; Transfuse (filter &#8594; vsearch),,16421443,36.06439111,22851,17150324,74.59529338,67897564,50747240,77319,36517,40802,7297,0.83345506,0.472290123,0.527709877,0.602924059
consensus 2 -- Transfuse 3,609,all (82) assemblies merged,consensus 2 &#8594; Transfuse (filter &#8594; vsearch &#8594; Transrate),,16097180,35.35225225,22504,16953323,73.738438,60582423,43629100,72339,35879,36460,7935,0.818893504,0.495984186,0.504015814,0.617788606
consensus 2 -- TF--Det,610,all (82) assemblies merged,consensus 2 &#8594; Transfuse (filter &#8594; vsearch &#8594; Transrate) &#8594; Detonate,,15694305,34.46746755,21974,16701546,72.64333454,52588728,35887182,66130,34955,31175,8859,0.797804355,0.52858007,0.47141993,0.63586917
consensus 2 -- evi4Full,611,all (82) assemblies merged,consensus 2 &#8594; evigene full set,,17356714,38.11841152,22261,16702212,72.64623131,118323902,101621690,95512,32583,62929,11231,0.743666408,0.34114038,0.65885962,0.467723182
Trinity k=25 -- Compacta d=0,701,Trinity (k=25),Compacta (d=0.0),,7257147,15.93797742,13929,7536860,32.78155462,8410061,873201,18550,15798,2752,28016,0.360569681,0.851644205,0.148355795,0.506638445
Trinity k=25 -- Compacta d=0.3,701,Trinity (k=25),Compacta (d=0.3),,7492924,16.45578538,14211,7847405,34.13226935,8862466,1015061,19675,16496,3179,27318,0.376500662,0.838424396,0.161575604,0.519649073
Trinity k=25 -- Compacta d=1,701,Trinity (k=25),Compacta (d=1.0),,9572017,21.02184107,15773,10478459,45.57603246,18937189,8458730,40559,21545,19014,22269,0.491737801,0.53120146,0.46879854,0.510708402
con2--Tf--Det--Compacta d=0,702,consensus 2,Compacta (d=0.0),,8947586,19.65048023,16457,9647591,41.96217407,14711773,5064182,26527,21229,5298,22585,0.484525494,0.800278961,0.199721039,0.603602451
con2--Tf--Det--Compacta d=0.3,702,consensus 2,Compacta (d=0.3),,9819609,21.56559686,16959,10602202,46.11425234,15990242,5388040,27695,22162,5533,21652,0.505820058,0.800216646,0.199783354,0.619838062
con2--Tf--Det--Compacta d=1,702,consensus 2,Compacta (d=1.0),,12002791,26.36025038,18511,12835005,55.82582367,27413018,14578013,35299,25429,9870,18385,0.580385265,0.72038868,0.27961132,0.642852629
"Trinity k=25 -- Grouper (with orphaned reads, min cut filter)",705,Trinity (k=25),Grouper (with orphaned reads and min cut filters),,8628265,18.94919488,15006,9455841,41.1281579,11649517,2193676,26118,19611,6507,24203,0.447596659,0.750861475,0.249138525,0.56085912
"Trinity k=25 -- Grouper (without orphaned reads, min cut filter)",705,Trinity (k=25),Grouper (without orphaned reads or min cut filters),,8565946,18.81233134,14927,9343588,40.63991375,11359284,2015696,25056,19273,5783,24541,0.439882229,0.769196999,0.230803001,0.559692174
"con2--Tf--Det--Grouper (with orphaned reads, min cut filter)",706,consensus 2,Grouper (with orphaned reads and min cut filters),,10842597,23.8122593,17556,11742480,51.07388879,17566595,5824115,28928,23245,5683,20569,0.530538184,0.803546737,0.196453263,0.639108081
"con2--Tf--Det--Grouper (without orphaned reads, min cut filter)",706,consensus 2,Grouper (without orphaned reads or min cut filters),,10846307,23.82040712,17562,11747695,51.09657142,17582144,5834449,28964,23269,5695,20545,0.531085954,0.803376605,0.196623395,0.639451483
"Trinity k=25 -- Corset d=0, clusters",703,Trinity (k=25),Corset clusters (d=0.0),,12064074,26.49483868,17700,13279697,57.76001047,30496370,17216673,66762,26746,40016,17068,0.61044415,0.400617118,0.599382882,0.483757777
"Trinity k=25 -- Corset d=0.3, clusters",703,Trinity (k=25),Corset clusters (d=0.3),,10578251,23.23170877,16192,12137854,52.79356706,18191311,6053457,42064,24298,17766,19516,0.554571598,0.577643591,0.422356409,0.565872517
"Trinity k=25 -- Corset d=1, clusters",703,Trinity (k=25),Corset clusters (d=1.0),,7399069,16.24966322,14061,7710003,33.53463968,8543652,833649,18551,16079,2472,27735,0.366983156,0.866745728,0.133254272,0.515641786
"con2--Tf--Det--Corset d=0, clusters",704,consensus 2,Corset clusters (d=0.0),,15528534,34.10340514,21756,16569587,72.06937918,50422652,33853065,63882,34539,29343,9275,0.788309673,0.540668733,0.459331267,0.64141658
"con2--Tf--Det--Corset d=0.3, clusters",704,consensus 2,Corset clusters (d=0.3),,13149569,28.87877754,19778,14716298,64.00850309,30699998,15983700,47626,30205,17421,13609,0.689391519,0.634212405,0.365787595,0.660651794
"con2--Tf--Det--Corset d=1, clusters",704,consensus 2,Corset clusters (d=1.0),,9486473,20.83397132,16895,10267162,44.65699666,15659077,5391915,27619,22101,5518,21713,0.504427808,0.80021,0.19979,0.618789635
"Trinity k=25 -- Corset, super-clusters",703,Trinity (k=25),Corset superclusters,,7228098,15.87418068,13807,7486978,32.56459298,8219766,732788,17731,15536,2195,28278,0.354589857,0.876205516,0.123794484,0.504866358
"con2--Tf--Det--Corset, super-clusters",704,consensus 2,Corset superclusters,,8936659,19.62648261,16400,9633274,41.89990231,14653043,5019769,26328,21154,5174,22660,0.482813713,0.803479186,0.196520814,0.603176414
IDBA_HFk101.fa,idba,IDBA,trimmed reads; k=101,,13102184,28.77471171,20118,15470195,67.2875763,58514943,43044748,1894773,34581,1860192,9233,0.78926827,0.018250735,0.981749265,0.0356765
IDBA_HFk111.fa,idba,IDBA,trimmed reads; k=111,,13051339,28.6630471,20157,15533022,67.56084219,370916057,355383035,1753147,35013,1718134,8801,0.799128133,0.019971514,0.980028486,0.038969126
IDBA_HFk121.fa,idba,IDBA,trimmed reads; k=121,,12980278,28.50698459,19948,15455064,67.22176405,343302313,327847249,1563274,34483,1528791,9331,0.787031542,0.022058193,0.977941807,0.042913643
IDBA_HFk131.fa,idba,IDBA,trimmed reads; k=131,,12908961,28.35035985,19550,15227117,66.23030912,290591481,275364364,1273755,33050,1240705,10764,0.754325102,0.025946905,0.974053095,0.050168151
IDBA_HFk141.fa,idba,IDBA,trimmed reads; k=141,,12940632,28.41991497,19285,15123613,65.78011872,192953588,177829975,805052,31999,773053,11815,0.730337335,0.039747743,0.960252257,0.075392347
IDBA_HFk21.fa,idba,IDBA,trimmed reads; k=21,,11445552,25.13645505,22163,12817587,55.75006412,44982214,32164627,139786,35913,103873,7901,0.819669512,0.25691414,0.74308586,0.39120915
IDBA_HFk31.fa,idba,IDBA,trimmed reads; k=31,,13699370,30.08623771,22889,15332342,66.687985,62203027,46870685,173777,38969,134808,4845,0.889418907,0.224247167,0.775752833,0.358185771
IDBA_HFk41.fa,idba,IDBA,trimmed reads; k=41,,14460539,31.75789936,22968,16324676,71.00413937,67807669,51482993,183684,39916,143768,3898,0.911033003,0.217307985,0.782692015,0.350912975
IDBA_HFk51.fa,idba,IDBA,trimmed reads; k=51,,14494834,31.83321724,22770,16532469,71.90793453,73040705,56508236,195175,39726,155449,4088,0.90669649,0.203540412,0.796459588,0.332450448
IDBA_HFk61.fa,idba,IDBA,trimmed reads; k=61,,14301002,31.40752791,22416,16549661,71.98271109,76364246,59814585,210307,39570,170737,4244,0.903135984,0.188153509,0.811846491,0.311426446
IDBA_HFk71.fa,idba,IDBA,trimmed reads; k=71,,14142014,31.05836217,22157,16552477,71.99495928,79240118,62687641,228432,39453,188979,4361,0.900465605,0.172712229,0.827287771,0.289833459
IDBA_HFk81.fa,idba,IDBA,trimmed reads; k=81,,13798668,30.30431367,20294,15512944,67.47351297,96349360,80836416,317783,32770,285013,11044,0.74793445,0.103120683,0.896879317,0.181251504
IDBA_HFk91.fa,idba,IDBA,trimmed reads; k=91,,13879146,30.48105758,20957,15896071,69.13992295,131447315,115551244,531902,35161,496741,8653,0.802506048,0.066104282,0.933895718,0.122147031
IDBA_HTk101.fa,idba,IDBA,normalized trimmed reads; k=101,,12176833,26.74247737,15749,13386622,58.2250805,20187295,6800673,34213,22235,11978,21579,0.507486192,0.649899161,0.350100839,0.569930921
IDBA_HTk111.fa,idba,IDBA,normalized trimmed reads; k=111,,11960904,26.26825912,15155,13065240,56.82723026,18916419,5851179,30203,20713,9490,23101,0.472748437,0.685792802,0.314207198,0.559682235
IDBA_HTk121.fa,idba,IDBA,normalized trimmed reads; k=121,,11741086,25.78549995,14475,12728977,55.36465514,17743140,5014163,26702,19167,7535,24647,0.437462911,0.7178114,0.2821886,0.543621306
IDBA_HTk131.fa,idba,IDBA,normalized trimmed reads; k=131,,11547267,25.35983917,13818,12409734,53.97610847,16801931,4392197,23827,17766,6061,26048,0.405486831,0.745624711,0.254375289,0.525302701
IDBA_HTk141.fa,idba,IDBA,normalized trimmed reads; k=141,,11379064,24.99043565,13167,12135265,52.78230621,15990624,3855359,21205,16512,4693,27302,0.376865842,0.778684273,0.221315727,0.507913072
IDBA_HTk21.fa,idba,IDBA,normalized trimmed reads; k=21,,11344767,24.91511338,21904,12705756,55.26365545,30738976,18033220,82280,35330,46950,8484,0.806363263,0.429387457,0.570612543,0.560375593
IDBA_HTk31.fa,idba,IDBA,normalized trimmed reads; k=31,,13375198,29.37429871,22314,14983941,65.17261568,35488868,20504927,86452,37433,49019,6381,0.85436162,0.432991718,0.567008282,0.57471635
IDBA_HTk41.fa,idba,IDBA,normalized trimmed reads; k=41,,14010350,30.76920475,22213,15837461,68.88499889,36033807,20196346,86810,37907,48903,5907,0.865180079,0.436666283,0.563333717,0.580398702
IDBA_HTk51.fa,idba,IDBA,normalized trimmed reads; k=51,,13879524,30.48188774,21771,15914170,69.2186445,36310332,20396162,88142,37356,50786,6458,0.85260419,0.423816115,0.576183885,0.56618873
IDBA_HTk61.fa,idba,IDBA,normalized trimmed reads; k=61,,13592200,29.85087345,21336,15844954,68.91758968,33792233,17947279,86240,36939,49301,6875,0.843086685,0.428327922,0.571672078,0.568056346
IDBA_HTk71.fa,idba,IDBA,normalized trimmed reads; k=71,,13337025,29.29046405,20925,15755133,68.52691345,30702837,14947704,82808,36571,46237,7243,0.834687543,0.441636074,0.558363926,0.577640536
IDBA_HTk81.fa,idba,IDBA,normalized trimmed reads; k=81,,12634755,27.74815501,17045,14028044,61.01494396,23732641,9704597,45682,25478,20204,18336,0.581503629,0.557725143,0.442274857,0.569366229
IDBA_HTk91.fa,idba,IDBA,normalized trimmed reads; k=91,,12395460,27.2226209,16382,13719004,59.67077522,21763704,8044700,39368,23814,15554,20000,0.543524901,0.604907539,0.395092461,0.572575798
rnaSPAdes_HFk33.fa,102,rnaSPAdes,trimmed reads; k=33,,9163562,20.1248017,17322,10742833,46.72592654,16570392,5827559,48784,25905,22879,17909,0.591249372,0.531014267,0.468985733,0.559515324
rnaSPAdes_HFk49.fa,102,rnaSPAdes,trimmed reads; k=49,,8511294,18.69230589,16881,10131542,44.06711779,16725225,6593683,52840,25507,27333,18307,0.582165518,0.482721423,0.517278577,0.527800195
rnaSPAdes_HFk55.fa,102,rnaSPAdes,trimmed reads; k=55,,9892303,21.72524573,16534,11557943,50.27124555,17113144,5555201,45978,24788,21190,19026,0.565755238,0.539127409,0.460872591,0.552120456
rnaSPAdes_HFk77.fa,102,rnaSPAdes,trimmed reads; k=77,,10441827,22.93209755,18584,12689200,55.19164517,26374948,13685748,106430,30591,75839,13223,0.698201488,0.287428357,0.712571643,0.407217593
rnaSPAdes_HTk33.fa,102,rnaSPAdes,normalized trimmed reads; k=33,,9511254,20.88839478,19473,11912912,51.81518237,20574473,8661561,75200,33446,41754,10368,0.763363309,0.444760638,0.555239362,0.562051523
rnaSPAdes_HTk49.fa,102,rnaSPAdes,normalized trimmed reads; k=49,,8957585,19.6724398,19944,11718437,50.96931382,22474619,10756182,91517,36033,55484,7781,0.822408363,0.393730127,0.606269873,0.53251657
rnaSPAdes_HTk55.fa,102,rnaSPAdes,normalized trimmed reads; k=55,,11037128,24.23948376,19440,13796476,60.0077395,21938623,8142147,75221,34607,40614,9207,0.789861688,0.460070991,0.539929009,0.581459235
rnaSPAdes_HTk77.fa,102,rnaSPAdes,normalized trimmed reads; k=577,,11354943,24.93746167,19578,14434338,62.78211875,23124113,8689775,84673,36542,48131,7272,0.834025654,0.431566143,0.568433857,0.568804626
SOAPdenovo_HFk101.fa,103,SOAPdenovo-Trans,trimmed reads; k=101,,2474449,5.434327332,3653,2518766,10.95536672,3482567,963801,5450,3956,1494,39858,0.090290775,0.72587156,0.27412844,0.160604092
SOAPdenovo_HFk111.fa,103,SOAPdenovo-Trans,trimmed reads; k=111,,1485682,3.262820248,2086,1495295,6.50378204,1953633,458338,2857,2204,653,41610,0.050303556,0.771438572,0.228561428,0.094448373
SOAPdenovo_HFk121.fa,103,SOAPdenovo-Trans,trimmed reads; k=121,,732602,1.60892347,953,734950,3.196663274,915080,180130,1203,984,219,42830,0.022458575,0.817955112,0.182044888,0.043716818
SOAPdenovo_HFk21.fa,103,SOAPdenovo-Trans,trimmed reads; k=21,,9558919,20.99307554,19418,10906243,47.43667795,20213290,9307047,53732,28746,24986,15068,0.65609166,0.534988461,0.465011539,0.58938347
SOAPdenovo_HFk23.fa,103,SOAPdenovo-Trans,trimmed reads; k=23,,9794226,21.5098513,19436,11248893,48.92703331,21140720,9891827,55980,29281,26699,14533,0.668302369,0.523061808,0.476938192,0.586828867
SOAPdenovo_HFk25.fa,103,SOAPdenovo-Trans,trimmed reads; k=25,,9960432,21.87486905,19576,11425607,49.69565043,21846799,10421192,58436,29702,28734,14112,0.67791117,0.508282566,0.491717434,0.580968215
SOAPdenovo_HFk27.fa,103,SOAPdenovo-Trans,trimmed reads; k=27,,10103305,22.18864341,19633,11637754,50.6183833,22561945,10924191,62631,30120,32511,13694,0.6874515,0.480912008,0.519087992,0.565926065
SOAPdenovo_HFk29.fa,103,SOAPdenovo-Trans,trimmed reads; k=29,,10158239,22.30928818,19713,11745193,51.08568897,23072427,11327234,69272,30541,38731,13273,0.6970603,0.440885206,0.559114794,0.540137594
SOAPdenovo_HFk31.fa,103,SOAPdenovo-Trans,trimmed reads; k=31,,10196548,22.39342152,19773,11837638,51.48777828,23404627,11566989,83760,30863,52897,12951,0.704409549,0.368469436,0.631530564,0.483844671
SOAPdenovo_HFk41.fa,103,SOAPdenovo-Trans,trimmed reads; k=41,,10050760,22.07324531,20123,11910238,51.80355181,25762245,13852007,114430,31830,82600,11984,0.726480121,0.278161321,0.721838679,0.402290134
SOAPdenovo_HFk51.fa,103,SOAPdenovo-Trans,trimmed reads; k=51,,8749304,19.21501791,14788,9783934,42.55519763,22802923,13018989,63303,20328,42975,23486,0.463961291,0.321122222,0.678877778,0.379547597
SOAPdenovo_HFk61.fa,103,SOAPdenovo-Trans,trimmed reads; k=61,,7876023,17.2971385,13709,8678403,37.74669317,17221681,8543278,41649,17870,23779,25944,0.407860501,0.429061922,0.570938078,0.418192668
SOAPdenovo_HFk71.fa,103,SOAPdenovo-Trans,trimmed reads; k=71,,6568813,14.4262743,11243,7033523,30.59229153,12301095,5267572,26784,13640,13144,30174,0.311316018,0.509259259,0.490740741,0.386413213
SOAPdenovo_HFk81.fa,103,SOAPdenovo-Trans,trimmed reads; k=81,,5025397,11.03665999,8140,5231814,22.75576253,8590367,3358553,16919,9278,7641,34536,0.211758799,0.548377564,0.451622436,0.305534059
SOAPdenovo_HFk91.fa,103,SOAPdenovo-Trans,trimmed reads; k=91,,3667390,8.054236605,5655,3763125,16.36770322,5642661,1879536,9854,6248,3606,37566,0.142602821,0.634057236,0.365942764,0.232838936
SOAPdenovo_HTk101.fa,103,SOAPdenovo-Trans,normalized trimmed reads; k=101,,2204204,4.840821549,3618,2252685,9.798048041,3104299,851614,5214,3958,1256,39856,0.090336422,0.759110088,0.240889912,0.161458758
SOAPdenovo_HTk111.fa,103,SOAPdenovo-Trans,normalized trimmed reads; k=111,,1184610,2.601612925,1965,1196262,5.203138719,1612644,416382,2670,2099,571,41715,0.047907062,0.786142322,0.213857678,0.090310645
SOAPdenovo_HTk121.fa,103,SOAPdenovo-Trans,normalized trimmed reads; k=121,,407929,0.89588418,718,415646,1.807851287,560205,144559,950,781,169,43033,0.017825353,0.822105263,0.177894737,0.034894111
SOAPdenovo_HTk21.fa,103,SOAPdenovo-Trans,normalized trimmed reads; k=21,,8655789,19.00964245,19518,10077440,43.83180127,19783181,9705741,55478,29118,26360,14696,0.664582097,0.5248567,0.4751433,0.586512509
SOAPdenovo_HTk23.fa,103,SOAPdenovo-Trans,normalized trimmed reads; k=23,,8872502,19.4855825,19487,10400003,45.23478827,20732735,10332732,57377,29606,27771,14208,0.675720089,0.515990728,0.484009272,0.585150853
SOAPdenovo_HTk25.fa,103,SOAPdenovo-Trans,normalized trimmed reads; k=25,,9002731,19.7715884,19559,10564798,45.95156373,21288566,10723768,58910,29899,29011,13915,0.68240745,0.507536921,0.492463079,0.58212297
SOAPdenovo_HTk27.fa,103,SOAPdenovo-Trans,normalized trimmed reads; k=27,,9177059,20.15444349,19641,10807086,47.00539481,22015972,11208886,60865,30349,30516,13465,0.692678139,0.498628111,0.501371889,0.579848871
SOAPdenovo_HTk29.fa,103,SOAPdenovo-Trans,normalized trimmed reads; k=29,,9309863,20.44610455,19646,11001719,47.85195058,22501030,11499311,62559,30709,31850,13105,0.700894691,0.490880609,0.509119391,0.577383359
SOAPdenovo_HTk31.fa,103,SOAPdenovo-Trans,normalized trimmed reads; k=31,,9303888,20.43298239,19671,11044009,48.03589084,22680037,11636028,63782,30895,32887,12919,0.70513991,0.484384309,0.515615691,0.574277854
SOAPdenovo_HTk41.fa,103,SOAPdenovo-Trans,normalized trimmed reads; k=41,,9192180,20.18765188,19978,11015721,47.91285225,23414354,12398633,63096,31411,31685,12403,0.716916967,0.497828705,0.502171295,0.587615752
SOAPdenovo_HTk51.fa,103,SOAPdenovo-Trans,normalized trimmed reads; k=51,,7898106,17.34563667,14545,8889874,38.66648579,15887752,6997878,35462,19733,15729,24081,0.450381157,0.556454797,0.443545203,0.497830365
SOAPdenovo_HTk61.fa,103,SOAPdenovo-Trans,normalized trimmed reads; k=61,,7084513,15.55884265,13511,7865794,34.21225227,13288290,5422496,29188,17525,11663,26289,0.399986306,0.60041798,0.39958202,0.480123832
SOAPdenovo_HTk71.fa,103,SOAPdenovo-Trans,normalized trimmed reads; k=71,,5981820,13.13713393,11191,6456696,28.08338387,10218856,3762160,21351,13619,7732,30195,0.310836719,0.637862395,0.362137605,0.417985115
SOAPdenovo_HTk81.fa,103,SOAPdenovo-Trans,normalized trimmed reads; k=81,,4639120,10.18832743,8096,4850436,21.09695983,7232077,2381641,13667,9252,4415,34562,0.211165381,0.676959099,0.323040901,0.321915068
SOAPdenovo_HTk91.fa,103,SOAPdenovo-Trans,normalized trimmed reads; k=91,,3387985,7.440613844,5646,3483763,15.15261887,4930583,1446820,8631,6252,2379,37562,0.142694116,0.724365659,0.275634341,0.238421203
TransLiG_HFk21.fa,104,TransLiG,trimmed reads; k=21,,13578904,29.82167308,17437,13298817,57.84317286,53505949,40207132,52240,23042,29198,20772,0.525904962,0.441079632,0.558920368,0.479771795
TransLiG_HFk23.fa,104,TransLiG,trimmed reads; k=23,,13686478,30.0579246,17067,13492298,58.68471801,52302098,38809800,52142,22535,29607,21279,0.514333318,0.432185187,0.567814813,0.469694443
TransLiG_HFk25.fa,104,TransLiG,trimmed reads; k=25,,13595279,29.85763548,16770,13522366,58.8154987,50524403,37002037,51235,22233,29002,21581,0.507440544,0.433941641,0.566058359,0.46782186
TransLiG_HFk27.fa,104,TransLiG,trimmed reads; k=27,,13421098,29.47510322,16532,13465039,58.56615505,49351038,35885999,51276,22074,29202,21740,0.503811567,0.430493798,0.569506202,0.464275949
TransLiG_HFk29.fa,104,TransLiG,trimmed reads; k=29,,13220902,29.03543742,16174,13375350,58.17605296,47879216,34503866,50517,21736,28781,22078,0.496097138,0.430270998,0.569729002,0.460845321
TransLiG_HFk31.fa,104,TransLiG,trimmed reads; k=31,,12991906,28.53252173,15938,13291952,57.81331356,46896649,33604697,51127,21661,29466,22153,0.494385356,0.423670468,0.576329532,0.456304442
TransLiG_HTk21.fa,104,TransLiG,normalized trimmed reads; k=21,,13491630,29.63000396,18181,13331901,57.98707164,46744550,33412649,52894,24775,28119,19039,0.565458529,0.468389609,0.531610391,0.512367126
TransLiG_HTk23.fa,104,TransLiG,normalized trimmed reads; k=23,,13810570,30.33045256,17918,13662538,59.42517648,45889738,32227200,52358,24338,28020,19476,0.555484548,0.464838229,0.535161771,0.506134842
TransLiG_HTk25.fa,104,TransLiG,normalized trimmed reads; k=25,,13794646,30.29548065,17566,13725895,59.7007476,44812394,31086499,51298,23937,27361,19877,0.546332223,0.466626379,0.533373621,0.503343427
TransLiG_HTk27.fa,104,TransLiG,normalized trimmed reads; k=27,,13661223,30.00246016,17330,13686347,59.52873367,43703871,30017524,50998,23644,27354,20170,0.539644862,0.463626025,0.536373975,0.498755432
TransLiG_HTk29.fa,104,TransLiG,normalized trimmed reads; k=29,,13426656,29.48730957,16976,13594031,59.12720545,42483320,28889289,49896,23257,26639,20557,0.530812069,0.466109508,0.533890492,0.496361114
TransLiG_HTk31.fa,104,TransLiG,normalized trimmed reads; k=31,,13221577,29.03691984,16682,13482427,58.64178412,41587328,28104901,50044,22908,27136,20906,0.522846579,0.457757174,0.542242826,0.488141661
Trinity_HTk21.fa,105,Trinity,Trinity's <em>in silico</em> normalization of trimmed reads; k=21,,11664608,25.61754074,17588,12866065,55.96091907,34319771,21453706,77924,26528,51396,17286,0.605468572,0.340434269,0.659565731,0.43582119
Trinity_HTk23.fa,105,Trinity,Trinity's <em>in silico</em> normalization of normalized trimmed reads; k=23,,11600521,25.47679436,17272,12811771,55.72476744,33826298,21014527,78149,26050,52099,17764,0.594558817,0.333337599,0.666662401,0.427178735
Trinity_HTk25.fa,105,Trinity,Trinity's <em>in silico</em> normalization of normalized trimmed reads; k=25,,12180008,26.74945023,17832,13397895,58.27411239,36959269,23561374,82740,27066,55674,16748,0.617747752,0.327121102,0.672878898,0.427738357
Trinity_HTk27.fa,105,Trinity,Trinity's <em>in silico</em> normalization of normalized trimmed reads; k=27,,11915156,26.16778843,17532,13178323,57.3190845,36454764,23276441,83121,26593,56528,17221,0.606952116,0.319931185,0.680068815,0.419001851
Trinity_HTk29.fa,105,Trinity,Trinity's <em>in silico</em> normalization of normalized trimmed reads; k=29,,11693699,25.68142972,17270,12994577,56.51988171,35656763,22662186,82877,26190,56687,17624,0.597754143,0.316010473,0.683989527,0.41344689
Trinity_HTk31.fa,105,Trinity,Trinity's <em>in silico</em> normalization of normalized trimmed reads; k=31,,11408322,25.05469139,16997,12744846,55.43367732,35051732,22306886,82673,25728,56945,18086,0.587209568,0.311201964,0.688798036,0.406808605
median,106,median,of all single k-mer assemblies,,11426937,25.09557322,17710,12778308.5,55.57922238,23409490.5,12017330.5,57906.5,26359,29334,17455,0.601611357,0.458914082,0.541085918,0.479947814
"cat 15, cluster ORFs @ 90% aa identity",507,15 assemblies merged,DRAP (cluster ORFs at 90% aa identity),,14315811,31.4400511,21631,16325555,71.00796258,91542007,75216452,176875,38213,138662,5601,0.872164148,0.21604523,0.78395477,0.346306341
"cat 15, 90%aa --> 95% nt identity",507,15 assemblies merged,DRAP (cluster ORFs at 90% aa identity &#8594; cluster contigs at 95% nt identity),,12966904,28.47761292,20062,14984885,65.17672161,54440578,39455693,91741,34535,57206,9279,0.788218378,0.376440196,0.623559804,0.509534875
"cat 15, 90%aa --> 95% nt identity --> tpm>0",507,15 assemblies merged,DRAP (cluster ORFs at 90% aa identity &#8594; cluster contigs at 95% nt identity &#8594; TPM>0 (used Salmon; original method used eXpress),,12814382,28.14264765,19881,14688755,63.88870488,45549687,30860932,72555,33260,39295,10554,0.75911809,0.458410861,0.541589139,0.571629901
"cat 15, 90%aa --> 95% nt identity --> tpm>10",507,15 assemblies merged,DRAP (cluster ORFs at 90% aa identity &#8594; cluster contigs at 95% nt identity &#8594; TPM>10 (used Salmon; original method used eXpress),,4452448,9.778362722,13926,4698773,20.43730197,8124164,3425391,22142,16018,6124,27796,0.365590907,0.723421552,0.276578448,0.485717751
"cat 15, 90%aa --> 95% nt identity --> tpm>1",507,15 assemblies merged,DRAP (cluster ORFs at 90% aa identity &#8594; cluster contigs at 95% nt identity &#8594; TPM>1 (used Salmon; original method used eXpress),,12210250,26.81586701,19203,13849685,60.23917191,33901999,20052314,56817,30545,26272,13269,0.697151595,0.537603182,0.462396818,0.607069392
"cat 15, 90%aa --> 95% nt identity --> tpm>3",507,15 assemblies merged,DRAP (cluster ORFs at 90% aa identity &#8594; cluster contigs at 95% nt identity &#8594; TPM>3 (used Salmon; original method used eXpress),,10177375,22.35131422,18074,11341286,49.32889644,21751037,10409751,42528,26191,16337,17623,0.597776966,0.615853085,0.384146915,0.60668041
"cat 15, 90%aa --> 95% nt identity --> tpm>5",507,15 assemblies merged,DRAP (cluster ORFs at 90% aa identity &#8594; cluster contigs at 95% nt identity &#8594; TPM>5 (used Salmon; original method used eXpress),,7748479,17.01702933,16900,8442854,36.72217336,14932273,6489419,33146,22172,10974,21642,0.506048295,0.668919327,0.331080673,0.576195426
"cat 15, 90%aa --> 95% nt identity --> tpm>0 -->TR 3/4",507,15 assemblies merged,DRAP (cluster ORFs at 90% aa identity &#8594; cluster contigs at 95% nt identity &#8594; TPM>0 &#8594;  Transrate contigs passing 3 of 4 criteria (used Salmon TPM>0; original method used eXpress FPKM>1 &amp;contigs meeting min. threshold based on all 4 crieteria),,11894285,26.12195203,18961,13383194,58.21017042,32249951,18866757,50813,29443,21370,14371,0.671999817,0.579438333,0.420561667,0.622295962
"cat 15, 90%aa --> 95% nt identity --> tpm>1 -->TR 3/4",507,15 assemblies merged,DRAP (cluster ORFs at 90% aa identity &#8594; cluster contigs at 95% nt identity &#8594; TPM>1 &#8594;  Transrate contigs passing 3 of 4 criteria (used Salmon TPM>1; original method used eXpress FPKM>1 &amp;contigs meeting min. threshold based on all 4 crieteria),,11869678,26.0679107,18711,13294718,57.82534427,29456060,16161342,46960,28490,18470,15324,0.650248779,0.606686542,0.393313458,0.627712781
"cat 15, 90%aa --> 95% nt identity --> tpm>0 -->TR 4/4",507,15 assemblies merged,DRAP (cluster ORFs at 90% aa identity &#8594; cluster contigs at 95% nt identity &#8594; TPM>0 &#8594;  Transrate contigs passing 4 of 4 criteria (used Salmon TPM>0; original method used eXpress FPKM>1),,7678865,16.86414468,16264,8509996,37.01420733,16301420,7791424,33790,22228,11562,21586,0.507326425,0.65782776,0.34217224,0.572857069
"cat 15, 90%aa --> 95% nt identity --> tpm>1 -->TR 4/4",507,15 assemblies merged,DRAP (cluster ORFs at 90% aa identity &#8594; cluster contigs at 95% nt identity &#8594; TPM>1 &#8594;  Transrate contigs passing 4 of 4 criteria (used Salmon TPM>1; original method used eXpress FPKM>1),,9028885,19.8290272,16723,9936497,43.21877003,18778682,8842185,34760,23138,11622,20676,0.528096042,0.665650173,0.334349827,0.588947998
"cat 4, cluster ORFs @ 90% aa identity",407,4 assemblies merged,DRAP (cluster ORFs at 90% aa identity),,13379761,29.38431986,20677,15462353,67.25346754,48859421,33397068,111210,35891,75319,7923,0.819167389,0.322731769,0.677268231,0.463037981
"cat 4, 90%aa --> 95% nt identity",407,4 assemblies merged,DRAP (cluster ORFs at 90% aa identity &#8594; cluster contigs at 95% nt identity),,12075558,26.52005957,19096,13902113,60.46720738,27915185,14013072,64199,31220,32979,12594,0.71255763,0.48630041,0.51369959,0.578078565
"cat 4, 90%aa --> 95% nt identity --> tpm>0",407,4 assemblies merged,DRAP (cluster ORFs at 90% aa identity  &#8594; cluster contigs at 95% nt identity &#8594; TPM>0 (used Salmon; original method used eXpress),,12040540,26.44315385,19033,13815096,60.08872714,26740729,12925633,60888,30766,30122,13048,0.702195645,0.505288398,0.494711602,0.587686959
"cat 4, 90%aa --> 95% nt identity --> tpm>10",407,4 assemblies merged,DRAP (cluster ORFs at 90% aa identity &#8594; cluster contigs at 95% nt identity &#8594; TPM>10 (used Salmon; original method used eXpress),,4440171,9.75140026,15434,4948326,21.52273215,7813849,2865523,34049,19046,15003,24768,0.434701237,0.559370319,0.440629681,0.489218242
"cat 4, 90%aa --> 95% nt identity --> tpm>1",407,4 assemblies merged,DRAP (cluster ORFs at 90% aa identity &#8594; cluster contigs at 95% nt identity &#8594; TPM>1 (used Salmon; original method used eXpress),,11834350,25.99032417,18734,13519877,58.8046728,24264775,10744898,56877,29738,27139,14076,0.678732825,0.522847548,0.477152452,0.590678412
"cat 4, 90%aa --> 95% nt identity --> tpm>3",407,4 assemblies merged,DRAP (cluster ORFs at 90% aa identity &#8594; cluster contigs at 95% nt identity &#8594; TPM>3 (used Salmon; original method used eXpress),,10168395,22.33159256,18089,11491846,49.9837568,18362538,6870692,50351,26967,23384,16847,0.6154882,0.535580227,0.464419773,0.57276058
"cat 4, 90%aa --> 95% nt identity --> tpm>5",407,4 assemblies merged,DRAP (cluster ORFs at 90% aa identity &#8594; cluster contigs at 95% nt identity &#8594; TPM>5 (used Salmon; original method used eXpress),,7622910,16.74125761,17346,8609724,37.44797403,13323177,4713453,44103,24134,19969,19680,0.550828502,0.54721901,0.45278099,0.549017824
"cat 4, 90%aa --> 95% nt identity --> tpm>0 -->TR 3/4",407,4 assemblies merged,DRAP (cluster ORFs at 90% aa identity &#8594; cluster contigs at 95% nt identity &#8594; TPM>0 &#8594;  Transrate contigs passing 3 of 4 criteria (used Salmon TPM>0; original method used eXpress FPKM>1 &amp;contigs meeting min. threshold based on all 4 crieteria),,10533967,23.13445328,13561,11043415,48.03330723,17132878,6089463,21565,17039,4526,26775,0.388893961,0.790122884,0.209877116,0.521237706
"cat 4, 90%aa --> 95% nt identity --> tpm>1 -->TR 3/4",407,4 assemblies merged,DRAP (cluster ORFs at 90% aa identity &#8594; cluster contigs at 95% nt identity &#8594; TPM>1 &#8594;  Transrate contigs passing 3 of 4 criteria (used Salmon TPM>1; original method used eXpress FPKM>1 &amp;contigs meeting min. threshold based on all 4 crieteria),,10499738,23.05928034,13365,10986156,47.78425935,16504548,5518392,20816,16625,4191,27189,0.379444926,0.798664489,0.201335511,0.514466966
"cat 4, 90%aa --> 95% nt identity --> tpm>0 -->TR 4/4",407,4 assemblies merged,DRAP (cluster ORFs at 90% aa identity &#8594; cluster contigs at 95% nt identity &#8594; TPM>0 &#8594;  Transrate contigs passing 4 of 4 criteria (used Salmon TPM>0; original method used eXpress FPKM>1),,7347567,16.13655572,9035,7462790,32.45938733,9677544,2214754,10880,10101,779,33713,0.230542749,0.928400735,0.071599265,0.369364098
"cat 4, 90%aa --> 95% nt identity --> tpm>1 -->TR 4/4",407,4 assemblies merged,DRAP (cluster ORFs at 90% aa identity &#8594; cluster contigs at 95% nt identity &#8594; TPM>1 &#8594;  Transrate contigs passing 4 of 4 criteria (used Salmon TPM>1; original method used eXpress FPKM>1),,7696126,16.90205289,9073,7805999,33.95217406,10170455,2364456,10911,10134,777,33680,0.231295933,0.928787462,0.071212538,0.370360895
,,,,,,,,,,,,,,,,,,,
,,,,,,,,,,,,,,,,,,,
