ContigSetID,cbID,contigSet,methodHTML,methodFails,transcriptBaseCoverage,transcriptBaseCoveragePercent,transcriptsPartial,contigBaseCoverage,contigBaseCoveragePercent,contigAssembledBases,contigAdditionalBases,contigsAssembled,contigsTP,contigsFP,contigsFN,contigSensitivity,contigSpecificity,contigFDR,contigF1
StringTie reference,107,StringTie (genome-guided),,,190151406,100,40477,88526928,100,88526928,0,46876,46876,0,0,1,1,0,1
evi ok,201,Trinity (k=25),evigene ok set,,20309590,10.68074669,13193,25018868,28.26130824,47661087,22642219,41832,20368,21464,26508,0.434508064,0.486899981,0.513100019,0.459214502
evi full,201,Trinity (k=25),evigene ok + alt/cull set,,25060773,13.17937823,15315,31905557,36.04051075,81522199,49616642,60269,24297,35972,22579,0.518324942,0.403142577,0.596857423,0.453534929
evi4F --> TF1,202,Trinity (k=25),evigene full set &#8594; Transfuse (filter),,24840763,13.06367569,15019,31495925,35.57779052,77104260,45608335,52484,22879,29605,23997,0.488074921,0.435923329,0.564076671,0.460527375
evi4F --> TF2,202,Trinity (k=25),evigene full set &#8594; Transfuse (filter &#8594; vsearch),,24320284,12.78995749,14867,30921814,34.92927485,74891693,43969879,51452,22728,28724,24148,0.484853656,0.4417321,0.5582679,0.46228948
evi4F --> TF3,202,Trinity (k=25),evigene full set &#8594; Transfuse (filter &#8594; vsearch &#8594; Transrate),,24299635,12.77909825,14845,30877216,34.87889696,74367539,43490323,51028,22643,28385,24233,0.483040362,0.443736772,0.556263228,0.462555156
evi4 --> TF --> Det,203,Trinity (k=25),evigene full set &#8594; Transfuse (filter &#8594; vsearch &#8594; Transrate) &#8594; Detonate,,24129403,12.6895738,14662,30579378,34.54245922,71698447,41119069,48401,22084,26317,24792,0.471115283,0.456271565,0.543728435,0.46357463
transfuse 1 (filter),204,Trinity (k=25),Transfuse (filter),,26718292,14.05106203,16428,35291667,39.86545992,96073082,60781415,74536,27448,47088,19428,0.585544842,0.368251583,0.631748417,0.452146411
transfuse 2 (vsearch),204,Trinity (k=25),Transfuse (filter &#8594; vsearch),,25896749,13.61901526,16178,34262515,38.70293003,92128234,57865719,72310,27087,45223,19789,0.577843673,0.374595492,0.625404508,0.454533251
transfuse 3 (transrate),204,Trinity (k=25),Transfuse (filter &#8594; vsearch &#8594; Transrate),,25838843,13.58856268,16120,34160653,38.58786673,90856622,56695969,70805,26871,43934,20005,0.573235771,0.379507097,0.620492903,0.456675249
TF3 --> Det,205,Trinity (k=25),Transfuse (filter &#8594; vsearch &#8594; Transrate) &#8594; Detonate,,25615072,13.47088225,15765,33658644,38.02079747,86177918,52519274,63820,25639,38181,21237,0.546953665,0.401739267,0.598260733,0.463232637
Detonate,206,Trinity (k=25),Detonate,,26822260,14.10573846,16301,35249349,39.81765752,96932083,61682734,72255,26746,45509,20130,0.570569161,0.370161235,0.629838765,0.449018308
evi ok,301,TransLiG (k=25),evigene ok set,,20074233,10.55697322,12335,24074268,27.19428827,49718538,25644270,30979,17569,13410,29307,0.374797338,0.567126118,0.432873882,0.451326183
evi full,301,TransLiG (k=25),evigene ok + alt/cull set,,23657313,12.44130322,13998,29275431,33.06952095,76203150,46927719,41840,20486,21354,26390,0.437025343,0.489627151,0.510372849,0.461833266
evi4F --> TF1,302,TransLiG (k=25),evigene full set &#8594; Transfuse (filter),,23602891,12.41268287,13920,29179277,32.96090541,73663159,44483882,39620,20178,19442,26698,0.430454817,0.509288238,0.490711762,0.466564928
evi4F --> TF2,302,TransLiG (k=25),evigene full set &#8594; Transfuse (filter &#8594; vsearch),,23422117,12.31761442,13876,29129024,32.90413963,72636070,43507046,39077,20316,18761,26560,0.433398754,0.519896614,0.480103386,0.472723465
evi4F --> TF3,302,TransLiG (k=25),evigene full set &#8594; Transfuse (filter &#8594; vsearch &#8594; Transrate),,23417727,12.31530573,13864,29119123,32.89295546,72388275,43269152,38915,20275,18640,26601,0.432524106,0.521007324,0.478992676,0.472660302
evi4 --> TF --> Det,303,TransLiG (k=25),evigene full set &#8594; Transfuse (filter &#8594; vsearch &#8594; Transrate) &#8594; Detonate,,23299031,12.25288389,13708,28881951,32.62504602,69791841,40909890,36912,19707,17205,27169,0.420407031,0.533891417,0.466108583,0.470401489
transfuse 1 (filter),304,TransLiG (k=25),Transfuse (filter),,24904722,13.09731152,14912,31817209,35.94071286,89281327,57464118,52059,23364,28695,23512,0.498421367,0.448798479,0.551201521,0.472310103
transfuse 2 (vsearch),304,TransLiG (k=25),Transfuse (filter &#8594; vsearch),,24594959,12.93440817,14827,31532391,35.61898251,87393518,55861127,50915,23383,27532,23493,0.498826692,0.459255622,0.540744378,0.478223967
transfuse 3 (transrate),304,TransLiG (k=25),Transfuse (filter &#8594; vsearch &#8594; Transrate),,24574213,12.92349792,14806,31505088,35.58814105,86593714,55088626,50502,23331,27171,23545,0.497717382,0.461981704,0.538018296,0.47918421
TF3 --> Det,305,TransLiG (k=25),Transfuse (filter &#8594; vsearch &#8594; Transrate) &#8594; Detonate,,24408712,12.83646149,14564,31130093,35.16454677,81243962,50113869,46041,22344,23697,24532,0.476661831,0.485306575,0.514693425,0.48094536
Detonate,306,TransLiG (k=25),Detonate,,24840380,13.06347427,14769,31605662,35.70174942,87120504,55514842,49499,22575,26924,24301,0.481589726,0.45606982,0.54393018,0.46848249
"4 merger, IDBA k=1/3RL, rnaSPAdes def, Trinity k-25, TransLiG k=25",401,4 assemblies merged,with trimmed reads: IDBA k=31; rnaSPAdes k=49; TransLiG k=25; with assembly <em>in-silico normalization</em>: Trinity k=25,,33656826,17.70001427,19926,45332706,51.20781555,390663390,345330684,412997,38923,374074,7953,0.830339619,0.094245237,0.905754763,0.16927717
evi ok,402,4 assemblies merged,evigene ok set,,21755076,11.44092303,13704,27575345,31.14910415,68715530,41140185,54753,23110,31643,23766,0.493002816,0.422077329,0.577922671,0.454791447
evi full,402,4 assemblies merged,evigene ok + alt/cull set,,29649176,15.5924043,17065,38378388,43.35221934,160835752,122457364,104585,29558,75027,17318,0.630557215,0.282621791,0.717378209,0.390305095
evi4F --> TF1,403,4 assemblies merged,evigene full set &#8594; Transfuse (filter),,23602891,12.41268287,13920,37460221,42.31505808,127344735,89884514,76654,28097,48557,18779,0.59938988,0.366543168,0.633456832,0.454901643
evi4F --> TF2,403,4 assemblies merged,evigene full set &#8594; Transfuse (filter &#8594; vsearch),,23422117,12.31761442,13876,36992849,41.78711476,122242603,85249754,74318,27907,46411,18969,0.595336633,0.375507952,0.624492048,0.46053435
evi4F --> TF3,403,4 assemblies merged,evigene full set &#8594; Transfuse (filter &#8594; vsearch &#8594; Transrate),,23417727,12.31530573,13864,36863320,41.64079883,118926513,82063193,72541,27800,44741,19076,0.593054015,0.383231552,0.616768448,0.465595351
evi4 --> TF --> Det,404,4 assemblies merged,evigene full set &#8594; Transfuse (filter &#8594; vsearch &#8594; Transrate) &#8594; Detonate,,27819800,14.63034147,16049,36317765,41.02454001,109566213,73248448,65251,26948,38303,19928,0.574878403,0.412989839,0.587010161,0.480669241
transfuse 1 (filter),405,4 assemblies merged,Transfuse (filter),,31368616,16.49665215,18475,42641994,48.16838782,205750344,163108350,158593,36091,122502,10785,0.769924908,0.227569943,0.772430057,0.351303603
transfuse 2 (vsearch),405,4 assemblies merged,Transfuse (filter &#8594; vsearch),,30466967,16.0224779,18093,41833873,47.2555345,167378914,125545041,136009,35640,100369,11236,0.76030378,0.262041483,0.737958517,0.389753124
transfuse 3 (transrate),405,4 assemblies merged,Transfuse (filter &#8594; vsearch &#8594; Transrate),,30204344,15.88436533,17964,41488657,46.86557857,158981906,117493249,130268,35430,94838,11446,0.755823876,0.271977769,0.728022231,0.400013548
TF3 --> Detonate,406,4 assemblies merged,Transfuse (filter &#8594; vsearch &#8594; Transrate) &#8594; Detonate,,29749313,15.64506602,17662,40721664,45.99918343,143422442,102700778,118188,34730,83458,12146,0.740890861,0.29385386,0.70614614,0.420806475
ORP 1 (orthomerged),408,4 assemblies merged,ORP (orthomerged),,22262367,11.7077057,16099,29836347,33.70313155,192844700,163008353,147773,31979,115794,14897,0.682204113,0.216406245,0.783593755,0.32858119
ORP 2 (cd-hit),408,4 assemblies merged,ORP (orthomerged &#8594; cd-hit c=1; original method used c=0.98),,22208897,11.679586,16016,29796039,33.65759964,166794688,136998649,132801,31875,100926,15001,0.679985494,0.240020783,0.759979217,0.354803342
ORP 3 (High exp),408,4 assemblies merged,ORP (orthomerged &#8594; cd-hit &#8594; high expression TPM&#8805;0.05; original method used TPM&#8805;1),,21643865,11.38243753,15225,28589304,32.29447203,151684560,123095256,89202,28412,60790,18464,0.606109736,0.318513038,0.681486962,0.417584033
ORP 4 (with blast),408,4 assemblies merged,ORP (orthomerged &#8594; cd-hit &#8594; high expression &#8594;  blast recovery of low exp.),,22121359,11.63355006,15675,29233449,33.02209809,156822422,127588973,96191,29344,66847,17532,0.625991979,0.305059725,0.694940275,0.410213397
"15 merger: IDBA 1/3, 1/2; rnaSPAdes def, Soap 1/3,1/2; TransLiG k=25,31 + norm; Trinity k=25",501,15 assemblies merged,with trimmed reads: IDBA k=31 41; rnaSPAdes k=49; Soap 25 41; TransLiG k=25 31 <br />with BBNorm normalized reads: IDBA k=31 41; rnaSPAdes k=49; Soap 25 41; TransLiG k=25 31 <br />with assembly <em>in-silico normalization</em>: Trinity k=25,,36020075,18.94283916,20955,48292090,54.55073512,1263917336,1215625246,1321818,40463,1281355,6413,0.863192252,0.030611627,0.969388373,0.059126437
evi ok,502,15 assemblies merged,evigene ok set,,21263409,11.18235697,13805,27185503,30.7087387,75690103,48504600,64824,24117,40707,22759,0.514485024,0.372038134,0.627961866,0.431817368
evi full,502,15 assemblies merged,evigene ok + alt/cull set,,31464010,16.54681954,18056,40971349,46.28122756,276150587,235179238,173886,32354,141532,14522,0.690203942,0.186064433,0.813935567,0.293112039
evi4F --> TF1,503,15 assemblies merged,evigene full set &#8594; Transfuse (filter),,29614632,15.57423772,17193,39072507,44.13629602,169279964,130207457,102848,30392,72456,16484,0.648348835,0.295504045,0.704495955,0.405973658
evi4F --> TF2,503,15 assemblies merged,evigene full set &#8594; Transfuse (filter &#8594; vsearch),,29318871,15.41869798,17074,38771961,43.79679932,163908042,125136081,100219,30276,69943,16600,0.645874221,0.302098404,0.697901596,0.411652334
evi4F --> TF3,503,15 assemblies merged,evigene full set &#8594; Transfuse (filter &#8594; vsearch &#8594; Transrate),,29036902,15.27041141,16945,38448729,43.43167652,155815485,117366756,95936,30074,65862,16802,0.64156498,0.31347982,0.68652018,0.421169089
evi4 --> TF --> Det,504,15 assemblies merged,evigene full set &#8594; Transfuse (filter &#8594; vsearch &#8594; Transrate) &#8594; Detonate,,28471195,14.97290796,16554,37689880,42.57448084,136228407,98538527,81917,28995,52922,17881,0.618546804,0.353955833,0.646044167,0.45025739
transfuse 1 (filter),505,15 assemblies merged,Transfuse (filter),,30676800,16.13282838,18235,42223075,47.695177,235045267,192822192,181309,35587,145722,11289,0.759173138,0.196278177,0.803721823,0.311913579
transfuse 2 (vsearch),505,15 assemblies merged,Transfuse (filter &#8594; vsearch),,29992202,15.77280054,17867,41664902,47.06466489,180002636,138337734,136564,35157,101407,11719,0.75,0.257439735,0.742560265,0.383307894
transfuse 3 (transrate),505,15 assemblies merged,Transfuse (filter &#8594; vsearch &#8594; Transrate),,29725689,15.63264223,17746,41277980,46.62759788,166506877,125228897,128144,34900,93244,11976,0.74451745,0.272349856,0.727650144,0.398811564
TF -->Det ,506,15 assemblies merged,Transfuse (filter &#8594; vsearch &#8594; Transrate) &#8594; Detonate,,29309299,15.4136641,17462,40563720,45.82076992,147008830,106445110,112481,34139,78342,12737,0.72828313,0.303509037,0.696490963,0.428459371
ORP 1 (orthomerged),508,15 assemblies merged,ORP (orthomerged),,20144677,10.59401948,15728,27485925,31.04809533,94778678,67292753,166458,31795,134663,15081,0.678278863,0.191009143,0.808990857,0.298077194
ORP 2 (cd-hit),508,15 assemblies merged,ORP (orthomerged &#8594; cd-hit c=1; original method used c=0.98),,22208897,11.679586,15602,27442905,30.99949995,87174388,59731483,142601,31664,110937,15212,0.675484256,0.222046129,0.777953871,0.334225262
ORP 3 (High exp),508,15 assemblies merged,ORP (orthomerged &#8594; cd-hit &#8594; high expression TPM&#8805;0.05; original method used TPM&#8805;1),,17983723,9.457580871,13918,23659551,26.72582403,62162380,38502829,78377,25772,52605,21104,0.549790938,0.328820955,0.671179045,0.411519085
ORP 4 (with blast),508,15 assemblies merged,ORP (orthomerged &#8594; cd-hit &#8594; high expression &#8594;  blast recovery of low exp.),,33656826,17.70001427,19926,25885519,29.24027704,71075683,45190164,90650,27841,62809,19035,0.593928663,0.30712631,0.69287369,0.40488344
All + norm,601,all (58) assemblies merged,with trimmed reads: IDBA k=21-71 step 10; rnaSPAdes k=29 33 49 55; Soap k=21-31 step 2 &amp; k=41-71 step 10; TransLiG k=21-31 step 2 <br />with BBNorm normalized reads: IDBA k=21-71 step 10; rnaSPAdes k=29 33 49 55; Soap k=21-31 step 2 &amp; k=41-71 step 10; TransLiG k=21-31 step 2 <br />with assembly <em>in-silico normalization</em>: Trinity k=21-31 step 2,,38544143,20.27023823,21958,51784498,58.49575849,4611786331,4560001833,4984001,42160,4941841,4716,0.899394146,0.008459067,0.991540933,0.016760497
evigene full,602,all (58) assemblies merged,evigene ok + alt/cull set,,33527446,17.63197375,19274,43653435,49.31091136,585115108,541461673,360172,35348,324824,11528,0.75407458,0.098141999,0.901858001,0.173679763
evi4F --> TF1,603,all (58) assemblies merged,evigene full set &#8594; Transfuse (filter),,29629354,15.58197997,17636,39710281,44.8567254,211529118,171818837,135920,32431,103489,14445,0.691846574,0.23860359,0.76139641,0.35483271
evi4F --> TF2,603,all (58) assemblies merged,evigene full set &#8594; Transfuse (filter &#8594; vsearch),,29593413,15.56307872,17607,39601182,44.73348719,205803057,166201875,133063,32357,100706,14519,0.690267941,0.243170528,0.756829472,0.359644102
evi4F --> TF3,603,all (58) assemblies merged,evigene full set &#8594; Transfuse (filter &#8594; vsearch &#8594; Transrate),,29201633,15.3570429,17435,39076306,44.14058737,187177513,148101207,123156,31995,91161,14881,0.682545439,0.259792458,0.740207542,0.376340924
evi4 --> TF --> Det,604,all (58) assemblies merged,evigene full set &#8594; Transfuse (filter &#8594; vsearch &#8594; Transrate) &#8594; Detonate,,28497439,14.98670959,16945,38077688,43.01254868,157185071,119107383,100306,30615,69691,16261,0.653106067,0.305216039,0.694783961,0.416015545
con2-eviFull Best evi set,606,all (58) assemblies merged,intersection of consensus 2 and evigene full sets,,21467419,11.28964516,13868,27395661,30.94613314,122809437,95413776,54316,22163,32153,24713,0.47280058,0.408038147,0.591961853,0.43803858
con2/evi4 -- Transfuse 1,607,all (58) assemblies merged,con2 U evigene full &#8594; Transfuse (filter),,20812606,10.94528115,13481,26644720,30.09787033,98160749,71516029,44602,21259,23343,25617,0.453515658,0.476637819,0.523362181,0.464789348
con2/evi4 -- Transfuse 2,607,all (58) assemblies merged,con2 U evigene full &#8594; Transfuse (filter &#8594; vsearch),,20660555,10.86531803,13408,26444735,29.87196732,96464915,70020180,44403,21126,23277,25750,0.450678386,0.475778664,0.524221336,0.462888507
con2/evi4 -- Transfuse 3,607,all (58) assemblies merged,con2 U evigene full &#8594; Transfuse (filter &#8594; vsearch &#8594; Transrate),,20547169,10.8056887,13366,26356551,29.77235469,93538366,67181815,43458,21042,22416,25834,0.448886424,0.484191633,0.515808367,0.465871101
con2/evi4 --TF--Det,608,all (58) assemblies merged,con2 U evigene full &#8594; Transfuse (filter &#8594; vsearch &#8594; Transrate) &#8594; Detonate,,20286020,10.6683513,13105,25926474,29.2865398,86148262,60221788,39266,20234,19032,26642,0.431649458,0.515305863,0.484694137,0.469782452
consensus 2,605,all (58) assemblies merged,consensus 2,,34325049,18.05143055,19328,47604676,53.7742324,450850306,403245630,202055,36841,165214,10035,0.785924567,0.182331543,0.817668457,0.295993669
consensus 3,605,all (58) assemblies merged,consensus 3,,31281679,16.45093226,17740,43097398,48.68281208,268117377,225019979,109912,32613,77299,14263,0.695729158,0.296719194,0.703280806,0.416013981
consensus 4,605,all (58) assemblies merged,consensus 4,,26904195,14.1488278,15460,36358543,41.07060283,151377963,115019420,60456,26767,33689,20109,0.571017152,0.442751753,0.557248247,0.498770171
consensus 5,605,all (58) assemblies merged,consensus 5,,17917999,9.423016835,10707,17917999,20.24016805,61699703,43781704,22631,10707,11924,36169,0.228411127,0.473112103,0.526887897,0.308084078
consensus 2 -- Transfuse 1,609,all (58) assemblies merged,consensus 2 &#8594; Transfuse (filter),,32213867,16.94116687,18160,44641049,50.42651994,212692563,168051514,112977,33983,78994,12893,0.724955201,0.300795737,0.699204263,0.425178132
consensus 2 -- Transfuse 2,609,all (58) assemblies merged,consensus 2 &#8594; Transfuse (filter &#8594; vsearch),,31671901,16.65614873,17944,44037844,49.74513969,206633813,162595969,111976,33683,78293,13193,0.718555337,0.30080553,0.69919447,0.424080276
consensus 2 -- Transfuse 3,609,all (58) assemblies merged,consensus 2 &#8594; Transfuse (filter &#8594; vsearch &#8594; Transrate),,31354378,16.48916443,17805,43609199,49.26094239,192377615,148768416,106321,33423,72898,13453,0.713008789,0.314359346,0.685640654,0.436340137
consensus 2 -- TF--Det,610,all (58) assemblies merged,consensus 2 &#8594; Transfuse (filter &#8594; vsearch &#8594; Transrate) &#8594; Detonate,,30771718,16.18274545,17445,42716271,48.2522911,162469201,119752930,90634,32394,58240,14482,0.691057257,0.357415539,0.642584461,0.471151189
consensus 2 -- evi4Full,611,all (58) assemblies merged,consensus 2 &#8594; evigene full set,,30409565,15.99229038,17021,40358005,45.5883943,224480173,184122168,93267,29151,64116,17725,0.621874733,0.31255428,0.68744572,0.416017925
Trinity k=25 -- Compacta d=0,701,Trinity (k=25),Compacta (d=0.0),,4065100,2.137822741,7914,6666744,7.530752677,17499845,10833101,42493,16697,25796,30179,0.356195068,0.392935307,0.607064693,0.373664246
Trinity k=25 -- Compacta d=0.3,701,Trinity (k=25),Compacta (d=0.3),,9992928,5.255248021,10691,13495291,15.24427799,29026844,15531553,53145,20785,32360,26091,0.443403874,0.391099821,0.608900179,0.415612721
Trinity k=25 -- Compacta d=1,701,Trinity (k=25),Compacta (d=1.0),,24872303,13.08026247,16523,33239794,37.54766459,96284624,63044830,110550,31208,79342,15668,0.665756464,0.282297603,0.717702397,0.396478345
con2--Tf--Det--Compacta d=0,702,consensus 2,Compacta (d=0.0),,3578251,1.881790451,5989,5556011,6.276068904,11205654,5649643,19210,11175,8035,35701,0.238394914,0.581728267,0.418271733,0.338195684
con2--Tf--Det--Compacta d=0.3,702,consensus 2,Compacta (d=0.3),,4042067,2.125709762,6313,6192844,6.995435332,12202952,6010108,20047,11747,8300,35129,0.250597321,0.585972964,0.414027036,0.351060174
con2--Tf--Det--Compacta d=1,702,consensus 2,Compacta (d=1.0),,6651375,3.497936271,8331,10193689,11.51478904,23000811,12807122,29197,16072,13125,30804,0.342862019,0.550467514,0.449532486,0.422541506
"Trinity k=25 -- Grouper (with orphaned reads, min cut filter)",705,Trinity (k=25),Grouper (with orphaned reads and min cut filters),,16951582,8.914781309,12739,21041134,23.76806072,36684910,15643776,45051,22105,22946,24771,0.471563273,0.490666134,0.509333866,0.480925082
"Trinity k=25 -- Grouper (without orphaned reads, min cut filter)",705,Trinity (k=25),Grouper (without orphaned reads or min cut filters),,17184103,9.037063339,12870,21380836,24.15178803,37871511,16490675,46798,22423,24375,24453,0.478347129,0.479144408,0.520855592,0.478745436
"con2--Tf--Det--Grouper (with orphaned reads, min cut filter)",706,consensus 2,Grouper (with orphaned reads and min cut filters),,18290559,9.618944916,12028,22969391,25.94621944,38875355,15905964,29380,19532,9848,27344,0.416673778,0.66480599,0.33519401,0.512274444
"con2--Tf--Det--Grouper (without orphaned reads, min cut filter)",706,consensus 2,Grouper (without orphaned reads or min cut filters),,18294641,9.621091626,12049,22998014,25.97855197,38986739,15988725,29550,19617,9933,27259,0.418487072,0.663857868,0.336142132,0.513359328
"Trinity k=25 -- Corset d=0, clusters",703,Trinity (k=25),Corset clusters (d=0.0),,27249726,14.33054142,17498,36613771,41.35890833,111301041,74687270,119106,32577,86529,14299,0.694961174,0.273512669,0.726487331,0.39253654
"Trinity k=25 -- Corset d=0.3, clusters",703,Trinity (k=25),Corset clusters (d=0.3),,20177883,10.61148241,14565,26045056,29.42049,59554294,33509238,84690,27102,57588,19774,0.578163666,0.320014169,0.679985831,0.41199094
"Trinity k=25 -- Corset d=1, clusters",703,Trinity (k=25),Corset clusters (d=1.0),,16217294,8.528621661,12050,19682686,22.23355813,33838449,14155763,40613,20363,20250,26513,0.434401399,0.50139118,0.49860882,0.46549852
"con2--Tf--Det--Corset d=0, clusters",704,consensus 2,Corset clusters (d=0.0),,30306242,15.93795315,17225,42104850,47.56163006,152611417,110506567,83513,31694,51819,15182,0.676124243,0.379509777,0.620490223,0.486145304
"con2--Tf--Det--Corset d=0.3, clusters",704,consensus 2,Corset clusters (d=0.3),,20841666,10.96056371,13707,27731704,31.32572724,59262834,31531130,47651,24765,22886,22111,0.528308729,0.51971627,0.48028373,0.523977276
"con2--Tf--Det--Corset d=1, clusters",704,consensus 2,Corset clusters (d=1.0),,11889463,6.252629549,9384,14602309,16.4947653,22023330,7421021,22443,14987,7456,31889,0.319715846,0.6677806,0.3322194,0.432406699
"Trinity k=25 -- Corset, super-clusters",703,Trinity (k=25),Corset superclusters,,4055781,2.13292191,7407,6517778,7.362480713,15931361,9413583,32281,15062,17219,31814,0.321315812,0.466590254,0.533409746,0.380560153
"con2--Tf--Det--Corset, super-clusters",704,consensus 2,Corset superclusters,,3536922,1.860055665,5782,5449478,6.155729249,10646978,5197500,17310,10604,6706,36272,0.226213841,0.612593876,0.387406124,0.330414732
IDBA_HFk21.fa,idba,IDBA,trimmed reads; k=21,,16738165,8.802546009,15422,22185959,25.06125481,63963386,41777427,109317,27166,82151,19710,0.57952897,0.248506637,0.751493363,0.347851696
IDBA_HFk31.fa,idba,IDBA,trimmed reads; k=31,,24631700,12.95373014,16876,32472435,36.68085602,84954344,52481909,106167,31087,75080,15789,0.663175186,0.292812267,0.707187733,0.406251838
IDBA_HFk41.fa,idba,IDBA,trimmed reads; k=41,,26001413,13.67405771,16951,34795897,39.30543823,93604417,58808520,110011,31695,78316,15181,0.676145576,0.288107553,0.711892447,0.404048774
IDBA_HFk51.fa,idba,IDBA,trimmed reads; k=51,,26679293,14.03055258,16946,36178296,40.86699586,102781638,66603342,110401,31856,78545,15020,0.679580169,0.288548111,0.711451889,0.405094197
IDBA_HFk61.fa,idba,IDBA,trimmed reads; k=61,,27076789,14.23959442,16873,37056318,41.85880933,106010472,68954154,108845,31740,77105,15136,0.677105555,0.291607332,0.708392668,0.407652147
IDBA_HFk71.fa,idba,IDBA,trimmed reads; k=71,,27069043,14.23552082,16689,37169524,41.98668681,102404687,65235163,104171,31368,72803,15508,0.669169724,0.301120273,0.698879727,0.41534092
IDBA_HTk21.fa,idba,IDBA,normalized trimmed reads; k=21,,18077032,9.506651768,15480,23478778,26.52162289,65713349,42234571,104254,26673,77581,20203,0.569011861,0.255846298,0.744153702,0.352980877
IDBA_HTk31.fa,idba,IDBA,normalized trimmed reads; k=31,,24962192,13.1275348,16882,32677143,36.91209414,84447181,51770038,101731,30630,71101,16246,0.65342606,0.301088164,0.698911836,0.412228226
IDBA_HTk41.fa,idba,IDBA,normalized trimmed reads; k=41,,26239609,13.79932421,16950,35045449,39.58733212,92385791,57340342,105736,31275,74461,15601,0.667185767,0.295783839,0.704216161,0.40986292
IDBA_HTk51.fa,idba,IDBA,normalized trimmed reads; k=51,,26888514,14.14058122,16956,36300804,41.00538087,101140037,64839233,106118,31415,74703,15461,0.67017237,0.296038372,0.703961628,0.410669699
IDBA_HTk61.fa,idba,IDBA,normalized trimmed reads; k=61,,27330938,14.37325055,16875,37256541,42.08498119,103695364,66438823,102950,31261,71689,15615,0.666887106,0.303652258,0.696347742,0.417297398
IDBA_HTk71.fa,idba,IDBA,normalized trimmed reads; k=71,,27307484,14.36091616,16710,37458396,42.31299656,100391784,62933388,99022,30941,68081,15935,0.660060585,0.312465917,0.687534083,0.424145636
rnaSPAdes_HFk29.fa,102,rnaSPAdes,trimmed reads; k=29,,23905206,12.57166934,15617,32461582,36.66859647,89598319,57136737,96912,31190,65722,15686,0.665372472,0.321838369,0.678161631,0.433833143
rnaSPAdes_HFk33.fa,102,rnaSPAdes,trimmed reads; k=33,,24102270,12.67530465,15663,32903892,37.16822976,90751368,57847476,99110,31496,67614,15380,0.671900333,0.317788316,0.682211684,0.431493431
rnaSPAdes_HFk49.fa,102,rnaSPAdes,trimmed reads; k=49,,24158105,12.70466809,15429,33110770,37.40191911,90815460,57704690,102007,31215,70792,15661,0.665905794,0.306008411,0.693991589,0.419322555
rnaSPAdes_HFk55.fa,102,rnaSPAdes,trimmed reads; k=55,,23977422,12.60964749,15316,32835859,37.0913797,89909564,57073705,101343,30813,70530,16063,0.657329977,0.304046653,0.695953347,0.415776655
rnaSPAdes_HTk29.fa,102,rnaSPAdes,normalized trimmed reads; k=29,,23660516,12.44298767,15506,32106674,36.26769247,89776407,57669733,94674,30871,63803,16005,0.658567284,0.326076853,0.673923147,0.436185094
rnaSPAdes_HTk33.fa,102,rnaSPAdes,normalized trimmed reads; k=33,,23850424,12.54285966,15555,32484988,36.69503589,90482349,57997361,96622,31222,65400,15654,0.666055124,0.323135518,0.676864482,0.435155891
rnaSPAdes_HTk49.fa,102,rnaSPAdes,normalized trimmed reads; k=49,,23818108,12.52586478,15277,32526032,36.74139918,89369260,56843228,98938,30821,68117,16055,0.65750064,0.311518325,0.688481675,0.422744044
rnaSPAdes_HTk55.fa,102,rnaSPAdes,normalized trimmed reads; k=55,,23619616,12.42147849,15186,32156871,36.32439499,88401317,56244446,97727,30373,67354,16503,0.647943511,0.310794356,0.689205644,0.420088103
SOAPdenovo_HFk21.fa,103,SOAPdenovo-Trans,trimmed reads; k=21,,20500184,10.78097945,14695,26549965,29.9908351,58067018,31517053,89521,26099,63422,20777,0.556766789,0.291540532,0.708459468,0.382691701
SOAPdenovo_HFk23.fa,103,SOAPdenovo-Trans,trimmed reads; k=23,,20484330,10.77264188,14618,26614562,30.06380386,57858852,31244290,87656,25942,61714,20934,0.553417527,0.295952359,0.704047641,0.385662891
SOAPdenovo_HFk25.fa,103,SOAPdenovo-Trans,trimmed reads; k=25,,20388184,10.72207902,14619,26374761,29.7929247,57443218,31068457,86053,25883,60170,20993,0.552158887,0.300779752,0.699220248,0.389425934
SOAPdenovo_HFk27.fa,103,SOAPdenovo-Trans,trimmed reads; k=27,,20237556,10.64286424,14680,26137448,29.52485599,57232813,31095365,85730,26016,59714,20860,0.55499616,0.303464365,0.696535635,0.392380435
SOAPdenovo_HFk29.fa,103,SOAPdenovo-Trans,trimmed reads; k=29,,19941937,10.48739918,14817,25707595,29.03929412,56460695,30753100,85711,26323,59388,20553,0.561545354,0.307113439,0.692886561,0.397067586
SOAPdenovo_HFk31.fa,103,SOAPdenovo-Trans,trimmed reads; k=31,,19556297,10.28459237,14859,25117105,28.37227674,55552271,30435166,85766,26271,59495,20605,0.560436044,0.306310193,0.693689807,0.396118876
SOAPdenovo_HFk41.fa,103,SOAPdenovo-Trans,trimmed reads; k=41,,17235066,9.063864613,14398,21715062,24.52932965,49463170,27748108,84988,23984,61004,22892,0.511647752,0.282204547,0.717795453,0.363768731
SOAPdenovo_HFk51.fa,103,SOAPdenovo-Trans,trimmed reads; k=51,,14123620,7.427565379,13428,17249877,19.48545758,40178119,22928242,80201,20449,59752,26427,0.436236027,0.254971883,0.745028117,0.321836367
SOAPdenovo_HFk61.fa,103,SOAPdenovo-Trans,trimmed reads; k=61,,9534769,5.014303707,10936,11067573,12.50192823,22880583,11813010,48747,14006,34741,32870,0.298788293,0.287320245,0.712679755,0.292942075
SOAPdenovo_HFk71.fa,103,SOAPdenovo-Trans,trimmed reads; k=71,,2455110,1.291134287,4251,2746866,3.102859279,4147975,1401109,8666,4843,3823,42033,0.103315129,0.558850681,0.441149319,0.174390551
SOAPdenovo_HTk21.fa,103,SOAPdenovo-Trans,normalized trimmed reads; k=21,,19450891,10.2291597,14276,25044089,28.28979788,62932318,37888229,75714,25115,50599,21761,0.535775237,0.331708799,0.668291201,0.409739783
SOAPdenovo_HTk23.fa,103,SOAPdenovo-Trans,normalized trimmed reads; k=23,,19298352,10.14893995,14212,24850100,28.07066794,62540839,37690739,73881,25010,48871,21866,0.533535285,0.338517345,0.661482655,0.414220294
SOAPdenovo_HTk25.fa,103,SOAPdenovo-Trans,normalized trimmed reads; k=25,,19287662,10.14331811,14204,24822320,28.03928766,61914100,37091780,72486,24928,47558,21948,0.531785989,0.343900891,0.656099109,0.417687371
SOAPdenovo_HTk27.fa,103,SOAPdenovo-Trans,normalized trimmed reads; k=27,,19082528,10.03543881,14230,24531411,27.71067691,61812189,37280778,71745,25013,46732,21863,0.533599283,0.348637536,0.651362464,0.421729711
SOAPdenovo_HTk29.fa,103,SOAPdenovo-Trans,normalized trimmed reads; k=29,,18833784,9.90462516,14338,24158581,27.28952822,61440540,37281959,71284,25286,45998,21590,0.539423159,0.354721957,0.645278043,0.427995938
SOAPdenovo_HTk31.fa,103,SOAPdenovo-Trans,normalized trimmed reads; k=31,,18630467,9.797701417,14368,23846505,26.93700723,60405319,36558814,71033,25200,45833,21676,0.537588531,0.354764687,0.645235313,0.427448286
SOAPdenovo_HTk41.fa,103,SOAPdenovo-Trans,normalized trimmed reads; k=41,,16776488,8.822699949,13919,21108428,23.84407601,52657613,31549185,67615,23019,44596,23857,0.491061524,0.34044221,0.65955779,0.40211021
SOAPdenovo_HTk51.fa,103,SOAPdenovo-Trans,normalized trimmed reads; k=51,,14129624,7.430722863,12976,17122017,19.34102695,41135249,24013232,60598,19514,41084,27362,0.416289786,0.322023829,0.677976171,0.363138992
SOAPdenovo_HTk61.fa,103,SOAPdenovo-Trans,normalized trimmed reads; k=61,,8399090,4.41705385,10683,9823236,11.0963254,22357974,12534738,40881,13654,27227,33222,0.291279119,0.333993787,0.666006213,0.311177456
SOAPdenovo_HTk71.fa,103,SOAPdenovo-Trans,normalized trimmed reads; k=71,,26958,0.014177124,98,30772,0.034760045,34254,3482,112,107,5,46769,0.002282618,0.955357143,0.044642857,0.004554354
TransLiG_HFk21.fa,104,TransLiG,trimmed reads; k=21,,22857215,12.02053431,15205,29232171,33.02065446,100417722,71185551,68191,24519,43672,22357,0.523060841,0.359563579,0.640436421,0.426169101
TransLiG_HFk23.fa,104,TransLiG,trimmed reads; k=23,,24505813,12.88752658,15259,31490334,35.57147493,97479302,65988968,63508,24701,38807,22175,0.526943425,0.388943125,0.611056875,0.447546746
TransLiG_HFk25.fa,104,TransLiG,trimmed reads; k=25,,25081448,13.19025114,15278,32181656,36.35239212,97452197,65270541,62043,24669,37374,22207,0.526260773,0.397611334,0.602388666,0.452978819
TransLiG_HFk27.fa,104,TransLiG,trimmed reads; k=27,,24929629,13.11041003,15309,32003450,36.15109066,93345788,61342338,60229,24476,35753,22400,0.522143528,0.406382308,0.593617692,0.457046823
TransLiG_HFk29.fa,104,TransLiG,trimmed reads; k=29,,24913868,13.10212137,15301,31978175,36.12254003,92054393,60076218,58765,24561,34204,22315,0.523956822,0.417952863,0.582047137,0.464989919
TransLiG_HFk31.fa,104,TransLiG,trimmed reads; k=31,,24719526,12.99991755,15208,31782607,35.90162645,89790535,58007928,57234,24247,32987,22629,0.517258298,0.423646783,0.576353217,0.465795793
TransLiG_HTk21.fa,104,TransLiG,normalized trimmed reads; k=21,,22067666,11.60531308,15088,28331605,32.00337529,107440249,79108644,70017,24314,45703,22562,0.518687601,0.347258523,0.652741477,0.41600438
TransLiG_HTk23.fa,104,TransLiG,normalized trimmed reads; k=23,,23935192,12.58743887,15186,30641793,34.61296319,104495633,73853840,65552,24425,41127,22451,0.521055551,0.372604955,0.627395045,0.434500302
TransLiG_HTk25.fa,104,TransLiG,normalized trimmed reads; k=25,,24560096,12.91607384,15262,31442147,35.5170429,106605202,75163055,64848,24549,40299,22327,0.523700828,0.378562176,0.621437824,0.43945795
TransLiG_HTk27.fa,104,TransLiG,normalized trimmed reads; k=27,,24360689,12.81120635,15177,31178605,35.21934591,100055379,68876774,62488,24300,38188,22576,0.518388941,0.388874664,0.611125336,0.44438755
TransLiG_HTk29.fa,104,TransLiG,normalized trimmed reads; k=29,,24288672,12.77333285,15161,31072656,35.09966595,98526599,67453943,60769,24259,36510,22617,0.517514293,0.39920025,0.60079975,0.450722282
TransLiG_HTk31.fa,104,TransLiG,normalized trimmed reads; k=31,,24204968,12.72931319,15107,30874420,34.8757386,95573459,64699039,59181,23937,35244,22939,0.510645106,0.40447103,0.59552897,0.451398776
Trinity_HTk21.fa,105,Trinity,Trinity's <em>in silico</em> normalization of trimmed reads; k=21,,26432384,13.90070395,17242,35701367,40.32825696,101769727,66068360,131004,32919,98085,13957,0.702257019,0.251282404,0.748717596,0.370125928
Trinity_HTk23.fa,105,Trinity,Trinity's <em>in silico</em> normalization of normalized trimmed reads; k=23,,26707286,14.04527401,17277,36130684,40.81321335,103189391,67058707,131024,32948,98076,13928,0.702875672,0.25146538,0.74853462,0.370410343
Trinity_HTk25.fa,105,Trinity,Trinity's <em>in silico</em> normalization of normalized trimmed reads; k=25,,27364362,14.39082812,17773,36921027,41.70598465,117441389,80520362,142780,33854,108926,13022,0.72220326,0.237106037,0.762893963,0.35700426
Trinity_HTk27.fa,105,Trinity,Trinity's <em>in silico</em> normalization of normalized trimmed reads; k=27,,27124963,14.26492897,17731,36636880,41.38501225,116779695,80142815,142537,33611,108926,13265,0.71701937,0.23580544,0.76419456,0.354896443
Trinity_HTk29.fa,105,Trinity,Trinity's <em>in silico</em> normalization of normalized trimmed reads; k=29,,26903768,14.14860325,17650,36358597,41.07066383,113249666,76891069,140651,33275,107376,13601,0.709851523,0.236578481,0.763421519,0.35488223
Trinity_HTk31.fa,105,Trinity,Trinity's <em>in silico</em> normalization of normalized trimmed reads; k=31,,26469631,13.92029202,17507,35758257,40.39251989,109008402,73250145,138736,32756,105980,14120,0.698779759,0.236103102,0.763896898,0.352951318
median,106,median,of all single k-mer assemblies,,23920199,12.57955411,15260.5,31466240.5,35.54425892,89850049.5,57505037.5,85909.5,26057.5,60587,20818.5,0.555881475,0.31115634,0.68884366,0.411448963
"cat 15, cluster ORFs @ 90% aa identity",507,15 assemblies merged,DRAP (cluster ORFs at 90% aa identity),,28411421,14.94147301,18354,38406649,43.38414296,268120754,229714105,324610,36197,288413,10679,0.772186193,0.111509196,0.888490804,0.194876792
"cat 15, 90%aa --> 95% nt identity",507,15 assemblies merged,DRAP (cluster ORFs at 90% aa identity &#8594; cluster contigs at 95% nt identity),,26170823,13.76314988,17136,35942120,40.6002115,172072482,136130362,187278,34379,152899,12497,0.733403021,0.183572016,0.816427984,0.293644354
"cat 15, 90%aa --> 95% nt identity --> tpm>0",507,15 assemblies merged,DRAP (cluster ORFs at 90% aa identity &#8594; cluster contigs at 95% nt identity &#8594; TPM>0 (used Salmon; original method used eXpress),,24403721,12.83383674,16126,33091773,37.3804601,135686433,102594660,122842,31102,91740,15774,0.663495179,0.253187021,0.746812979,0.366513864
"cat 15, 90%aa --> 95% nt identity --> tpm>10",507,15 assemblies merged,DRAP (cluster ORFs at 90% aa identity &#8594; cluster contigs at 95% nt identity &#8594; TPM>10 (used Salmon; original method used eXpress),,9394850,4.940720764,6767,10878076,12.28787245,17922291,7044215,12269,8656,3613,38220,0.184657394,0.705517972,0.294482028,0.292704371
"cat 15, 90%aa --> 95% nt identity --> tpm>1",507,15 assemblies merged,DRAP (cluster ORFs at 90% aa identity &#8594; cluster contigs at 95% nt identity &#8594; TPM>1 (used Salmon; original method used eXpress),,21244603,11.17246696,15018,28571761,32.27465546,91628787,63057026,91088,28484,62604,18392,0.607645704,0.312708589,0.687291411,0.412919312
"cat 15, 90%aa --> 95% nt identity --> tpm>3",507,15 assemblies merged,DRAP (cluster ORFs at 90% aa identity &#8594; cluster contigs at 95% nt identity &#8594; TPM>3 (used Salmon; original method used eXpress),,17426114,9.164336129,12319,21819606,24.64742253,46720297,24900691,46522,20436,26086,26440,0.4359587,0.439276041,0.560723959,0.437611084
"cat 15, 90%aa --> 95% nt identity --> tpm>5",507,15 assemblies merged,DRAP (cluster ORFs at 90% aa identity &#8594; cluster contigs at 95% nt identity &#8594; TPM>5 (used Salmon; original method used eXpress),,14205806,7.470786727,10163,17072077,19.28461473,32916504,15844427,29712,15312,14400,31564,0.326649031,0.515347334,0.484652666,0.399853763
"cat 15, 90%aa --> 95% nt identity --> tpm>0 -->TR 3/4",507,15 assemblies merged,DRAP (cluster ORFs at 90% aa identity &#8594; cluster contigs at 95% nt identity &#8594; TPM>0 &#8594;  Transrate contigs passing 3 of 4 criteria (used Salmon TPM>0; original method used eXpress FPKM>1 &amp;contigs meeting min. threshold based on all 4 crieteria),,23547642,12.3836276,15737,31836457,35.9624554,109199040,77362583,103728,30144,73584,16732,0.643058281,0.290606201,0.709393799,0.400308093
"cat 15, 90%aa --> 95% nt identity --> tpm>1 -->TR 3/4",507,15 assemblies merged,DRAP (cluster ORFs at 90% aa identity &#8594; cluster contigs at 95% nt identity &#8594; TPM>1 &#8594;  Transrate contigs passing 3 of 4 criteria (used Salmon TPM>1; original method used eXpress FPKM>1 &amp;contigs meeting min. threshold based on all 4 crieteria),,21085807,11.08895666,14882,28303101,31.97117718,86173608,57870507,84549,28099,56450,18777,0.599432545,0.332339827,0.667660173,0.427605098
"cat 15, 90%aa --> 95% nt identity --> tpm>0 -->TR 4/4",507,15 assemblies merged,DRAP (cluster ORFs at 90% aa identity &#8594; cluster contigs at 95% nt identity &#8594; TPM>0 &#8594;  Transrate contigs passing 4 of 4 criteria (used Salmon TPM>0; original method used eXpress FPKM>1),,16810372,8.840519433,13417,22532013,25.45215734,56646786,34114773,59781,24456,35325,22420,0.52171687,0.40909319,0.59090681,0.45859156
"cat 15, 90%aa --> 95% nt identity --> tpm>1 -->TR 4/4",507,15 assemblies merged,DRAP (cluster ORFs at 90% aa identity &#8594; cluster contigs at 95% nt identity &#8594; TPM>1 &#8594;  Transrate contigs passing 4 of 4 criteria (used Salmon TPM>1; original method used eXpress FPKM>1),,17706291,9.311680293,13362,23366194,26.39444803,59446546,36080352,55358,23872,31486,23004,0.509258469,0.431229452,0.568770548,0.467007062
"cat 4, cluster ORFs @ 90% aa identity",407,4 assemblies merged,DRAP (cluster ORFs at 90% aa identity),,27032849,14.21648652,17505,36755565,41.51907881,172805585,136050020,221029,34891,186138,11985,0.744325454,0.157857114,0.842142886,0.260472929
"cat 4, 90%aa --> 95% nt identity",407,4 assemblies merged,DRAP (cluster ORFs at 90% aa identity &#8594; cluster contigs at 95% nt identity),,25133247,13.21749207,16473,34431858,38.89421985,117355264,82923406,142289,33137,109152,13739,0.706907586,0.232885184,0.767114816,0.350350223
"cat 4, 90%aa --> 95% nt identity --> tpm>0",407,4 assemblies merged,DRAP (cluster ORFs at 90% aa identity  &#8594; cluster contigs at 95% nt identity &#8594; TPM>0 (used Salmon; original method used eXpress),,23667929,12.44688614,15583,31824789,35.94927523,98235488,66410699,102900,29683,73217,17193,0.633223825,0.288464529,0.711535471,0.396365239
"cat 4, 90%aa --> 95% nt identity --> tpm>10",407,4 assemblies merged,DRAP (cluster ORFs at 90% aa identity &#8594; cluster contigs at 95% nt identity &#8594; TPM>10 (used Salmon; original method used eXpress),,9621129,5.059720147,6732,11142370,12.5864189,16858249,5715879,11962,8636,3326,38240,0.184230736,0.721952851,0.278047149,0.293551786
"cat 4, 90%aa --> 95% nt identity --> tpm>1",407,4 assemblies merged,DRAP (cluster ORFs at 90% aa identity &#8594; cluster contigs at 95% nt identity &#8594; TPM>1 (used Salmon; original method used eXpress),,20479244,10.76996717,14590,27477597,31.03868802,76006650,48529053,82857,27449,55408,19427,0.585566175,0.331281606,0.668718394,0.423161416
"cat 4, 90%aa --> 95% nt identity --> tpm>3",407,4 assemblies merged,DRAP (cluster ORFs at 90% aa identity &#8594; cluster contigs at 95% nt identity &#8594; TPM>3 (used Salmon; original method used eXpress),,17287990,9.091697171,12023,21693455,24.50492239,41529910,19836455,43828,19759,24069,27117,0.421516341,0.450830519,0.549169481,0.435680896
"cat 4, 90%aa --> 95% nt identity --> tpm>5",407,4 assemblies merged,DRAP (cluster ORFs at 90% aa identity &#8594; cluster contigs at 95% nt identity &#8594; TPM>5 (used Salmon; original method used eXpress),,14267192,7.503069422,9985,17132180,19.35250707,29861170,12728990,28304,14910,13394,31966,0.318073214,0.526780667,0.473219333,0.396648045
"cat 4, 90%aa --> 95% nt identity --> tpm>0 -->TR 3/4",407,4 assemblies merged,DRAP (cluster ORFs at 90% aa identity &#8594; cluster contigs at 95% nt identity &#8594; TPM>0 &#8594;  Transrate contigs passing 3 of 4 criteria (used Salmon TPM>0; original method used eXpress FPKM>1 &amp;contigs meeting min. threshold based on all 4 crieteria),,23358260,12.28403223,15389,31302827,35.35966706,89797135,58494308,92013,29079,62934,17797,0.620338766,0.31603143,0.68396857,0.418737265
"cat 4, 90%aa --> 95% nt identity --> tpm>1 -->TR 3/4",407,4 assemblies merged,DRAP (cluster ORFs at 90% aa identity &#8594; cluster contigs at 95% nt identity &#8594; TPM>1 &#8594;  Transrate contigs passing 3 of 4 criteria (used Salmon TPM>1; original method used eXpress FPKM>1 &amp;contigs meeting min. threshold based on all 4 crieteria),,20437365,10.74794314,14504,27376763,30.92478596,73661657,46284894,78254,27196,51058,19680,0.580168956,0.34753495,0.65246505,0.434683929
"cat 4, 90%aa --> 95% nt identity --> tpm>0 -->TR 4/4",407,4 assemblies merged,DRAP (cluster ORFs at 90% aa identity &#8594; cluster contigs at 95% nt identity &#8594; TPM>0 &#8594;  Transrate contigs passing 4 of 4 criteria (used Salmon TPM>0; original method used eXpress FPKM>1),,18674654,9.820939215,13491,24717899,27.92133372,58375347,33657448,56029,24101,31928,22775,0.514143698,0.430152243,0.569847757,0.468412614
"cat 4, 90%aa --> 95% nt identity --> tpm>1 -->TR 4/4",407,4 assemblies merged,DRAP (cluster ORFs at 90% aa identity &#8594; cluster contigs at 95% nt identity &#8594; TPM>1 &#8594;  Transrate contigs passing 4 of 4 criteria (used Salmon TPM>1; original method used eXpress FPKM>1),,18697199,9.832795557,13332,24590759,27.7777164,58552021,33961262,52718,23496,29222,23380,0.501237307,0.445692173,0.554307827,0.471835653
